ID	annot_type
AAACAAGTATCTCCCA-1	Surrounding tumor
AAACACCAATAACTGC-1	Invasive
AAACAGAGCGACTCCT-1	Healthy
AAACAGGGTCTATATT-1	Invasive
AAACAGTGTTCCTGGG-1	Invasive
AAACATTTCCCGGATT-1	Invasive
AAACCCGAACGAAATC-1	Surrounding tumor
AAACCGGGTAGGTACC-1	Invasive
AAACCTAAGCAGCCGG-1	Invasive
AAACCTCATGAAGTTG-1	Surrounding tumor
AAACGAAGAACATACC-1	Tumor
AAACGAGACGGTTGAT-1	Invasive
AAACGCCCGAGATCGG-1	Healthy
AAACGGGCGTACGGGT-1	Invasive
AAACGGTTGCGAACTG-1	Surrounding tumor
AAACGTGTTCGCCCTA-1	Healthy
AAACTAACGTGGCGAC-1	Healthy
AAACTCGGTTCGCAAT-1	Invasive
AAACTCGTGATATAAG-1	Healthy
AAACTGCTGGCTCCAA-1	Healthy
AAACTTAATTGCACGC-1	Invasive
AAACTTGCAAACGTAT-1	Surrounding tumor
AAAGAATGTGGACTAA-1	Invasive
AAAGACCCAAGTCGCG-1	Invasive
AAAGACTGGGCGCTTT-1	Surrounding tumor
AAAGCTTGCCTACATA-1	Healthy
AAAGGCCCTATAATAC-1	Invasive
AAAGGCTACGGACCAT-1	Tumor
AAAGGCTCTCGCGCCG-1	Healthy
AAAGGGATGTAGCAAG-1	Invasive
AAAGGGCAGCTTGAAT-1	Surrounding tumor
AAAGGTAAGCTGTACC-1	Healthy
AAAGTAGCATTGCTCA-1	Surrounding tumor
AAAGTCACTGATGTAA-1	Invasive
AAAGTCGACCCTCAGT-1	Surrounding tumor
AAAGTGTGATTTATCT-1	Surrounding tumor
AAAGTTGACTCCCGTA-1	Surrounding tumor
AAATAACCATACGGGA-1	Surrounding tumor
AAATAAGGTAGTGCCC-1	Surrounding tumor
AAATACCTATAAGCAT-1	Healthy
AAATAGCTTAGACTTT-1	Tumor
AAATAGGGTGCTATTG-1	Tumor
AAATCCGATACACGCC-1	Invasive
AAATCGTGTACCACAA-1	Invasive
AAATCTAGCCCTGCTA-1	Invasive
AAATGATTCGATCAGC-1	Healthy
AAATGCTCGTTACGTT-1	Invasive
AAATGGCATGTCTTGT-1	Surrounding tumor
AAATGGCCCGTGCCCT-1	Invasive
AAATGGTCAATGTGCC-1	Invasive
AAATGTGGGTGCTCCT-1	Tumor
AAATTAACGGGTAGCT-1	Invasive
AAATTACACGACTCTG-1	Surrounding tumor
AAATTACCTATCGATG-1	Healthy
AAATTCCAGGTCCAAA-1	Tumor
AAATTGATAGTCCTTT-1	Invasive
AAATTGCGGCGGTTCT-1	Invasive
AAATTGGTGAGAAGCA-1	Healthy
AAATTTACCGAAATCC-1	Healthy
AAATTTGCGGGTGTGG-1	Invasive
AACAACTGGTAGTTGC-1	Invasive
AACAATACATTGTCGA-1	Invasive
AACAATTACTCTACGC-1	Invasive
AACACACGCTCGCCGC-1	Invasive
AACACGACTGTACTGA-1	Tumor
AACACGAGACGCGGCC-1	Surrounding tumor
AACACGCGGCCGCGAA-1	Invasive
AACAGCTGTGTGGCAA-1	Invasive
AACAGGAAATCGAATA-1	Surrounding tumor
AACAGGATGGGCCGCG-1	Invasive
AACAGGTAGTATGGAT-1	Surrounding tumor
AACATATCAACTGGTG-1	Healthy
AACATCGATACGTCTA-1	Healthy
AACATTGAAGTTGATC-1	Invasive
AACATTGTGACTCGAG-1	Invasive
AACCAAGACTTCTCTG-1	Invasive
AACCAGTATCACTCTT-1	Healthy
AACCATAGGGTTGAAC-1	Invasive
AACCATGGGATCGCTA-1	Invasive
AACCCAGAGACGGAGA-1	Invasive
AACCCATCCCATGATC-1	Invasive
AACCCGACAACCCGTG-1	Invasive
AACCCGAGCAGAATCG-1	Tumor
AACCCGCTGTATTCCA-1	Invasive
AACCCTACTGTCAATA-1	Surrounding tumor
AACCCTGGTGGAACCA-1	Tumor
AACCGAGCTTGGTCAT-1	Invasive
AACCGCTAAGGGATGC-1	Surrounding tumor
AACCGTTGTGTTTGCT-1	Surrounding tumor
AACCTCGCTTTAGCCC-1	Surrounding tumor
AACCTGTCACGGAATT-1	Tumor
AACCTTTAAATACGGT-1	Tumor
AACCTTTACGACGTCT-1	Healthy
AACGATAATGCCGTAG-1	Tumor
AACGATAGAAGGGCCG-1	Invasive
AACGATATGTCAACTG-1	Invasive
AACGCATGATCTGGGT-1	Healthy
AACGCGAACGGCAACA-1	Invasive
AACGCGACCTTGGGCG-1	Invasive
AACGCGGTCTCCAGCC-1	Invasive
AACGCTGTTGCTGAAA-1	Invasive
AACGGACGTACGTATA-1	Surrounding tumor
AACGGCCATCTCCGGT-1	Invasive
AACGTACTGTGGGTAC-1	Invasive
AACGTCAGACTAGTGG-1	Invasive
AACGTCGCTGCACTTC-1	Invasive
AACGTGATGAAGGACA-1	Surrounding tumor
AACGTGCGAAAGTCTC-1	Invasive
AACTACCCGTTTGTCA-1	Surrounding tumor
AACTAGGCTTGGGTGT-1	Tumor
AACTCAAGTTAATTGC-1	Invasive
AACTCCAGAGCGTGTT-1	Invasive
AACTCCTAATCCCATG-1	Surrounding tumor
AACTCGATGGCGCAGT-1	Invasive
AACTCTCAATAGAGCG-1	Healthy
AACTGAGGTCAGCGTC-1	Healthy
AACTGATATTAGGCCT-1	Invasive
AACTGGGTCCCGACGT-1	Surrounding tumor
AACTGGTGTGGGCCTT-1	Surrounding tumor
AACTTCTGCGTCTATC-1	Invasive
AACTTGCCCGTATGCA-1	Invasive
AACTTGCGTTCTCGCG-1	Invasive
AACTTTAGCTGCTGAG-1	Surrounding tumor
AAGAAGGATCAGTTAG-1	Invasive
AAGACATACGTGGTTT-1	Invasive
AAGACCCAACTGAACA-1	Tumor
AAGACTAACCCGTTGT-1	Invasive
AAGACTGCAAGCTACT-1	Invasive
AAGAGATGAATCGGTA-1	Surrounding tumor
AAGAGCTCTTTATCGG-1	Invasive
AAGAGGATGTACGCGA-1	Invasive
AAGAGGCATGGATCGC-1	Invasive
AAGAGGCCCTTTGGAA-1	Surrounding tumor
AAGATGGCACCGGACC-1	Invasive
AAGATTGGCGGAACGT-1	Healthy
AAGCACCCTGCGTATC-1	Tumor
AAGCATACTCTCCTGA-1	Tumor
AAGCCGAAGCGGTTTA-1	Surrounding tumor
AAGCCGCCGTGAAATC-1	Invasive
AAGCGCAGGGCTTTGA-1	Invasive
AAGCGGCGTCATGGGT-1	Healthy
AAGCGTCCCTCATCGA-1	Invasive
AAGCTAGATCGAGTAA-1	Healthy
AAGCTCGTGCCAAGTC-1	Invasive
AAGCTCTTTCATGGTG-1	Tumor
AAGGAGAACTTATAAG-1	Tumor
AAGGAGCGGTTGGTGC-1	Invasive
AAGGATCGATCGCTTG-1	Tumor
AAGGATGAGGGACCTC-1	Healthy
AAGGCAGGCTGTCTCC-1	Surrounding tumor
AAGGCGCGTAAAGCTT-1	Surrounding tumor
AAGGCTGTGCTCATCG-1	Invasive
AAGGGAACGACTGGCT-1	Invasive
AAGGGACAGATTCTGT-1	Healthy
AAGGGACTATGCATTC-1	Invasive
AAGGTATCCTAATATA-1	Surrounding tumor
AAGGTGATAAACCAGC-1	Surrounding tumor
AAGTAGAAGACCGGGT-1	Invasive
AAGTAGTGACGCGAGG-1	Invasive
AAGTCAATTGTCGTCA-1	Tumor
AAGTGACGACCGAATT-1	Invasive
AAGTGAGTCGGGTTTA-1	Invasive
AAGTGCCTTGACTGTA-1	Tumor
AAGTGCGTTAGAATCT-1	Surrounding tumor
AAGTGCTTCTCTATTG-1	Invasive
AAGTGTTTGGAGACGG-1	Surrounding tumor
AAGTTCACTCCAAGCT-1	Invasive
AAGTTCAGTCTGCGTA-1	Healthy
AAGTTCGGCCAACAGG-1	Invasive
AAGTTGTGATGTTATA-1	Invasive
AAGTTTACTAATGGCA-1	Tumor
AAGTTTATGGGCCCAA-1	Invasive
AATAACAACGCTCGGC-1	Invasive
AATAACGTCGCGCCCA-1	Invasive
AATAAGTCCTCGAGAC-1	Tumor
AATACAATGTTTCAGG-1	Surrounding tumor
AATACCGGAGGGCTGT-1	Surrounding tumor
AATACCTGATGTGAAC-1	Invasive
AATAGAATCTGTTTCA-1	Surrounding tumor
AATAGCAAGCCTCCTG-1	Healthy
AATAGCTACCGCGTGC-1	Healthy
AATAGTCCGTCCCGAC-1	Tumor
AATATCAAGGTCGGAT-1	Invasive
AATATCGAATCAATGC-1	Surrounding tumor
AATATCGAGGGTTCTC-1	Healthy
AATATTGGAGTATTGA-1	Invasive
AATCAGACTGCAGGAC-1	Invasive
AATCAGGTTTCATTTA-1	Invasive
AATCATGTAAAGACTC-1	Invasive
AATCCAAGGGCCTGAG-1	Invasive
AATCCATGCAAGGGTG-1	Invasive
AATCGCCTCAGCGCCA-1	Invasive
AATCGCGCAGAGGACT-1	Tumor
AATCGGGACACTACGA-1	Tumor
AATCGGTATAGCCCTC-1	Invasive
AATCGTGAGCCGAGCA-1	Invasive
AATCTAGGTTTACTTG-1	Invasive
AATCTATGCCGGAGCC-1	Surrounding tumor
AATCTGCGTTGGGACG-1	Healthy
AATCTGGCTTTCTAGT-1	Invasive
AATCTGGGTAGACCCT-1	Surrounding tumor
AATGACAGCAATGTCT-1	Surrounding tumor
AATGACTGTCAGCCGG-1	Invasive
AATGAGTTCGCATATG-1	Invasive
AATGATGATACGCTAT-1	Healthy
AATGATGCGACTCCTG-1	Healthy
AATGCAACCGGGTACC-1	Invasive
AATGCACCAAGCAATG-1	Healthy
AATGGTCCACCGTTCA-1	Surrounding tumor
AATGGTTCTCACAAGC-1	Invasive
AATGTATGGCACTGTA-1	Invasive
AATGTGCCCGAGGTGT-1	Invasive
AATGTGCTAATCTGAG-1	Invasive
AATGTTGTCGTGAGAC-1	Invasive
AATTAAAGGTCGGCGT-1	Invasive
AATTAACGGATTTCCA-1	Tumor
AATTCATAAGGGATCT-1	Healthy
AATTCATTGTCATGCA-1	Invasive
AATTCCAAGCATGTAC-1	Surrounding tumor
AATTCGATTCGAGGAT-1	Invasive
AATTGCAGCAATCGAC-1	Invasive
AATTGCGTGGATTACA-1	Invasive
AATTTGGGACATAGTA-1	Surrounding tumor
AATTTGGTTCCAAAGA-1	Surrounding tumor
ACAAACCATGCGTCCT-1	Invasive
ACAAAGCATGACCTAG-1	Invasive
ACAAATCGCACCGAAT-1	Surrounding tumor
ACAAATTCAGATCTGA-1	Healthy
ACAACAGCATGAGCTA-1	Surrounding tumor
ACAACGGTCCCTGCGA-1	Invasive
ACAAGCAGTGCCTAGC-1	Invasive
ACAAGGAAATCCGCCC-1	Healthy
ACAAGGACAAGAGGTT-1	Invasive
ACAAGGATGCTTTAGG-1	Invasive
ACAATAGTCGTACGTT-1	Surrounding tumor
ACAATCCATTTAAACC-1	Invasive
ACAATCGATCTTTATA-1	Tumor
ACAATGAATACGGAGA-1	Invasive
ACAATGATTCTTCTAC-1	Healthy
ACAATTGTGTCTCTTT-1	Invasive
ACAATTTGAGCAGTGG-1	Invasive
ACACAAAGACGGGTGG-1	Surrounding tumor
ACACACCAGGACCAGT-1	Invasive
ACACACTTTCTACACG-1	Invasive
ACACATGATCAAATCT-1	Invasive
ACACATTTCCGTAGAC-1	Invasive
ACACCACATAATTAGC-1	Surrounding tumor
ACACCCAGCATGCAGC-1	Invasive
ACACCCGAGAAATCCG-1	Invasive
ACACCGGTCTGACCGC-1	Invasive
ACACCTTAAGTAGGGC-1	Invasive
ACACCTTACTACTTGC-1	Tumor
ACACGAGACTCCTTCT-1	Invasive
ACACGGCACTATGCAT-1	Tumor
ACACGGGAACTTAGGG-1	Invasive
ACACGTAGGCCACAAG-1	Tumor
ACACTCCAATGTCACT-1	Invasive
ACACTGGGACAGTCGT-1	Tumor
ACAGAACTGAGAACAA-1	Invasive
ACAGATTAGGTTAGTG-1	Surrounding tumor
ACAGCATAGAGCCAGT-1	Invasive
ACAGCGACATTCTCAT-1	Invasive
ACAGCGCACCCGCAGC-1	Tumor
ACAGGCACGGATCCTT-1	Invasive
ACAGGCTTGCCCGACT-1	Invasive
ACAGTAATACAACTTG-1	Invasive
ACAGTATACCGTGGGA-1	Healthy
ACATAATAAGGCGGTG-1	Invasive
ACATCCCGGCCATACG-1	Healthy
ACATCCTGGTAACTGT-1	Tumor
ACATCGATCGTTTACC-1	Invasive
ACATCGGTCAGCCGCG-1	Invasive
ACATCGTTAACCTAGT-1	Tumor
ACATCTCAACGCGTAA-1	Tumor
ACATGGCGCCAAAGTA-1	Tumor
ACATGGCTCAATTTAG-1	Invasive
ACATTTGAAACCTAAC-1	Invasive
ACCAAACACCCAGCGA-1	Healthy
ACCAAACTAGAAATCC-1	Tumor
ACCAACACCACACACT-1	Healthy
ACCAACCGCACTCCAC-1	Invasive
ACCAAGAACGCGTGTC-1	Invasive
ACCAAGTCATCGGCAG-1	Invasive
ACCAATATGCAAGTTA-1	Tumor
ACCACAACTCAGAACA-1	Tumor
ACCACAAGTTTCTATC-1	Invasive
ACCACACGGTTGATGG-1	Invasive
ACCACCAATGTAACAA-1	Tumor
ACCACCCTCTCTTCTA-1	Healthy
ACCACGTGCAGCTATA-1	Healthy
ACCAGCCCGGTCTTTG-1	Tumor
ACCAGGAGTGTGATCT-1	Tumor
ACCAGTGCCCGGTCAA-1	Healthy
ACCAGTGCGGGAGACG-1	Surrounding tumor
ACCATATCCGCAATAA-1	Invasive
ACCATCCGCCAACTAG-1	Surrounding tumor
ACCATCGTATATGGTA-1	Invasive
ACCCAACGCCCGTGGC-1	Invasive
ACCCACCTACATGCTC-1	Surrounding tumor
ACCCATCTTGAGGGTA-1	Invasive
ACCCATTTGTCCCTCT-1	Invasive
ACCCGAGCGAAATTAC-1	Invasive
ACCCGATTGGTTCCGA-1	Surrounding tumor
ACCCGGAAACTCCCAG-1	Tumor
ACCCGGATGACGCATC-1	Tumor
ACCCGGTTACACTTCC-1	Invasive
ACCCGTAGTCTAGTTG-1	Surrounding tumor
ACCCGTGTCATCAGTA-1	Healthy
ACCCTATAGGACTGAG-1	Invasive
ACCCTCCCGTCAGGGC-1	Invasive
ACCCTCCCTTGCTATT-1	Surrounding tumor
ACCCTGGTAACGCCCT-1	Healthy
ACCCTTCATCTGCGAA-1	Surrounding tumor
ACCCTTTAGTTCTCCA-1	Tumor
ACCGAAAGGGCCCTGC-1	Invasive
ACCGAAGAGTCTGGTT-1	Invasive
ACCGACACATCTCCCA-1	Tumor
ACCGACTGAGTCCCAC-1	Invasive
ACCGAGTCTCCTTATT-1	Invasive
ACCGATAGGCATAACC-1	Surrounding tumor
ACCGATATTTAATCAT-1	Surrounding tumor
ACCGATGGTAGCATCG-1	Invasive
ACCGCAATAACTGCCT-1	Surrounding tumor
ACCGCGGTGGAAGTCG-1	Tumor
ACCGGGCCTTTGTTGA-1	Surrounding tumor
ACCGGTCAGGTACACC-1	Invasive
ACCGTGACCACGTGGG-1	Invasive
ACCGTTCCCGCTCTGA-1	Tumor
ACCTAAGTACCTTTCA-1	Surrounding tumor
ACCTAATCGACTTCCT-1	Invasive
ACCTACAGTATGTGGT-1	Tumor
ACCTACTATAAATCTA-1	Invasive
ACCTCCGCCCTCGCTG-1	Tumor
ACCTCCGTTATTCACC-1	Tumor
ACCTCGAACTTATGCT-1	Invasive
ACCTGCGTGTCATGTT-1	Surrounding tumor
ACCTTTCCTTTAGAAG-1	Tumor
ACGAAATGGGCGGCAC-1	Invasive
ACGACTCTAGGGCCGA-1	Invasive
ACGACTGGTCATACTC-1	Invasive
ACGAGAACCCATCACG-1	Invasive
ACGAGATATTTGCTTA-1	Tumor
ACGAGGATACCACTCT-1	Invasive
ACGAGGTTTACAACGT-1	Invasive
ACGAGTACGGATGCCC-1	Surrounding tumor
ACGATACATAGAACTA-1	Surrounding tumor
ACGATCATACATAGAG-1	Invasive
ACGATCATCTTGTAAA-1	Tumor
ACGATGCATATGTTAT-1	Invasive
ACGATGGATCCGATGC-1	Tumor
ACGCAAACTAATAGAT-1	Invasive
ACGCAATCACTACAGC-1	Healthy
ACGCATAAATGACATG-1	Healthy
ACGCATACGTTTACTA-1	Surrounding tumor
ACGCATTCGTGAGTAC-1	Invasive
ACGCCACTCGAAACAG-1	Invasive
ACGCCAGATGATTTCT-1	Surrounding tumor
ACGCCAGTGCGTTTGC-1	Invasive
ACGCCCAGCTGTCGAT-1	Tumor
ACGCCGCTAGACGACC-1	Healthy
ACGCGCTACACAGGGT-1	Invasive
ACGCGGGCCAAGGACA-1	Invasive
ACGCTAGTGATACACT-1	Healthy
ACGCTGTGAGGCGTAG-1	Surrounding tumor
ACGCTTAGTGTCTCTC-1	Surrounding tumor
ACGGAACACGAGTGCC-1	Invasive
ACGGAATTTAGCAAAT-1	Invasive
ACGGACTCTCAAAGCG-1	Tumor
ACGGAGCGCAAATTAC-1	Healthy
ACGGATGGTGCGGATA-1	Tumor
ACGGCGACGATGGGAA-1	Healthy
ACGGCGGGTTGCCCTG-1	Invasive
ACGGCTGGATGTAGAA-1	Invasive
ACGGGAGTGTCGGCCC-1	Surrounding tumor
ACGGGCGTATGCGACA-1	Healthy
ACGGTACAGTTCAATG-1	Invasive
ACGGTCACCGAGAACA-1	Invasive
ACGTACAGATTTCTCT-1	Tumor
ACGTACTTTGGCACGG-1	Surrounding tumor
ACGTAGATTGCTGATG-1	Invasive
ACGTAGGAGAGTCGCT-1	Invasive
ACGTATTACTCCGATC-1	Tumor
ACGTCCTAAACGAGAT-1	Tumor
ACGTGCGCCTCGTGCA-1	Invasive
ACGTTAATGTCGAAGA-1	Invasive
ACGTTAGATTTGCCCG-1	Invasive
ACGTTATTGGTCACTC-1	Invasive
ACGTTCCGCGCTCCGT-1	Surrounding tumor
ACGTTCGCAATCAATT-1	Tumor
ACGTTCGTTCAGGAAA-1	Invasive
ACGTTCTGTACAAGTC-1	Invasive
ACGTTTAGTTGTGATC-1	Surrounding tumor
ACTAATACGTCAGGCG-1	Healthy
ACTACAAAGAGAGGTG-1	Invasive
ACTACATCCCGACAAG-1	Invasive
ACTACCAGCTCTCTGG-1	Invasive
ACTACGCGTTAGAATT-1	Tumor
ACTAGTTGCGATCGTC-1	Surrounding tumor
ACTATATGCTGTGTTC-1	Healthy
ACTATCCAGGGCATGG-1	Tumor
ACTATCTGCCCGCGTA-1	Surrounding tumor
ACTATGTCCAGCTGCC-1	Invasive
ACTATTCGTCCGTGGT-1	Surrounding tumor
ACTATTTCCGGGCCCA-1	Invasive
ACTCAACGAATGTATT-1	Invasive
ACTCAAGTGCAAGGCT-1	Invasive
ACTCAATAAAGGCACG-1	Invasive
ACTCAGACCTGCTTCT-1	Invasive
ACTCATGGCAGCCTTC-1	Invasive
ACTCCAATATCATCAT-1	Invasive
ACTCCCATTCCTAAAG-1	Invasive
ACTCCCGAATTCGTTT-1	Surrounding tumor
ACTCCCGTAGACTAGG-1	Healthy
ACTCCCTAATGCTAAA-1	Tumor
ACTCCGGCCGACCACT-1	Invasive
ACTCGCCGTTCGATAA-1	Invasive
ACTCGTAACCCGTCCT-1	Surrounding tumor
ACTCGTCAGTAATCCC-1	Invasive
ACTCTCTGACTTAGGT-1	Invasive
ACTCTCTTATACACGA-1	Surrounding tumor
ACTCTGACCTAATAGA-1	Invasive
ACTCTTGTATAGTAAC-1	Invasive
ACTGAAACGCCGTTAG-1	Invasive
ACTGAATGGCGAAAGT-1	Surrounding tumor
ACTGATTTAGTGATTC-1	Tumor
ACTGCCCGCCATTCTC-1	Invasive
ACTGCCGTCGTAACTC-1	Surrounding tumor
ACTGCGGACACACCGT-1	Tumor
ACTGGGATGCCAGTGC-1	Invasive
ACTGTACGATACACAT-1	Invasive
ACTGTAGCACTTTGGA-1	Invasive
ACTGTATACGCGAGCA-1	Invasive
ACTGTCCAGGATTATA-1	Invasive
ACTGTCTTCTTTAGAA-1	Invasive
ACTGTGCTAGTAGATC-1	Invasive
ACTGTTTAGTGTAGGC-1	Tumor
ACTTACCGGGCGCGCA-1	Healthy
ACTTACGCATCCACGC-1	Tumor
ACTTAGTACGACAAGA-1	Invasive
ACTTATACTTACCCGG-1	Invasive
ACTTATTAGGATCGGT-1	Invasive
ACTTATTTATGTGCCA-1	Surrounding tumor
ACTTCAGGCTGATCCC-1	Surrounding tumor
ACTTCCATGCGGGACA-1	Invasive
ACTTCGCCATACGCAC-1	Invasive
ACTTGACTCCCTCTTT-1	Healthy
ACTTGCCATATTGTAC-1	Tumor
ACTTGGGACCCGGTGG-1	Invasive
ACTTGTAGTCCCTTCA-1	Surrounding tumor
ACTTGTGGATGGAACG-1	Surrounding tumor
ACTTGTTACCGGATCA-1	Surrounding tumor
ACTTTACCCTCATGAA-1	Tumor
ACTTTCCTATAGCTTC-1	Invasive
ACTTTGACTGCATCCT-1	Surrounding tumor
ACTTTGGTCGTGCTCC-1	Invasive
AGAAATTATGACTCGC-1	Surrounding tumor
AGAACCCTCAATTGGG-1	Invasive
AGAACGTGGTACATTC-1	Invasive
AGAACTGTACTTTGTA-1	Invasive
AGAAGAGCGCCGTTCC-1	Invasive
AGAAGGTACACTTCAC-1	Invasive
AGAAGGTTGCCGAATT-1	Invasive
AGAAGGTTGTAGGTCG-1	Invasive
AGAAGTGATTCGTGAT-1	Surrounding tumor
AGAATACAGGCTATCC-1	Surrounding tumor
AGAATGCGGGTTCGGA-1	Healthy
AGAATTATGGATTCGA-1	Healthy
AGAATTGTTTGACATA-1	Invasive
AGACATAGATCCTTCC-1	Invasive
AGACCATGGGATACAA-1	Invasive
AGACCCGCCCTCCTCG-1	Surrounding tumor
AGACCGCTCCGCGGTT-1	Surrounding tumor
AGACCGGGAAACCCTG-1	Surrounding tumor
AGACGAAGTGCCGGTC-1	Surrounding tumor
AGACGACGATGCCGCT-1	Invasive
AGACGGGCCGATTTAA-1	Healthy
AGACTAGCCTTCCAGA-1	Invasive
AGACTGTTACCGGGTC-1	Invasive
AGAGAAACACCAGAAA-1	Invasive
AGAGAACCGTCTAGGA-1	Healthy
AGAGAAGGAGTACAAT-1	Invasive
AGAGATCTCTAAAGCG-1	Surrounding tumor
AGAGCAGTTATGAGAC-1	Surrounding tumor
AGAGCCGCCGAGATTT-1	Tumor
AGAGCGGGCTAATCAT-1	Invasive
AGAGCGTACAAGCTCG-1	Surrounding tumor
AGAGCTACGAAAGCAT-1	Invasive
AGAGGCTTCGGAAACC-1	Surrounding tumor
AGAGGGACAATTGTCC-1	Healthy
AGAGGTATCTCGGTCC-1	Tumor
AGAGTAAACTTCACTA-1	Surrounding tumor
AGAGTATAGTGTTACG-1	Healthy
AGAGTTAGAGACCGAT-1	Healthy
AGATAACTTCAGGGCC-1	Invasive
AGATACCAATAGAACC-1	Invasive
AGATACCAGCACTTCA-1	Healthy
AGATACCGGTGTTCAC-1	Invasive
AGATACGACTTCATAT-1	Invasive
AGATATAATACGACTA-1	Surrounding tumor
AGATCGTGCATAAGAT-1	Healthy
AGATCTCAGGTGTGAT-1	Invasive
AGATGACTCGCCCACG-1	Invasive
AGATGAGGGTTGCGAT-1	Healthy
AGATGATGGAGTCTGG-1	Tumor
AGATGCAAGACGTGCA-1	Invasive
AGATTATAGGACGTTT-1	Invasive
AGATTCACAACCGATA-1	Invasive
AGCAAAGGCCGCTAGT-1	Tumor
AGCAACATATCTTATT-1	Surrounding tumor
AGCAACCGAAAGTAAT-1	Invasive
AGCACACGTTTAGACT-1	Invasive
AGCACCAGTACTCACG-1	Invasive
AGCACTACCGGCCTGT-1	Invasive
AGCACTACCTCACCAG-1	Tumor
AGCACTTAAGGACGCC-1	Invasive
AGCAGAAGGAGAAAGA-1	Tumor
AGCAGCCAGATGAATA-1	Tumor
AGCAGTCGAAGCATGC-1	Invasive
AGCATATCAATATGCT-1	Invasive
AGCATCATTTCGAAAG-1	Invasive
AGCATCGTCGATAATT-1	Invasive
AGCATTACGAGGCAAG-1	Invasive
AGCCAAGCTTTGTGTC-1	Tumor
AGCCACAGGTTACCCG-1	Invasive
AGCCACTCCCGTGCTT-1	Surrounding tumor
AGCCATATAGTATGTG-1	Surrounding tumor
AGCCCATACATGTAAG-1	Invasive
AGCCCGCAACAAGCAG-1	Invasive
AGCCCGCACTACAATG-1	Invasive
AGCCCGGCATTAGAGG-1	Invasive
AGCCCGGTAGCCTGTA-1	Invasive
AGCCCTAAGCGAAGTT-1	Invasive
AGCCCTCCCTGGTGGC-1	Invasive
AGCCCTTCTAATCCGA-1	Healthy
AGCCCTTGGACATCCC-1	Surrounding tumor
AGCCGTGGCTAAATGT-1	Invasive
AGCCTAATACCCACGT-1	Invasive
AGCCTTAAAGCGGAAG-1	Surrounding tumor
AGCGACATCCCATTCA-1	Invasive
AGCGACCAACGATATT-1	Surrounding tumor
AGCGAGACGTGAAGGC-1	Invasive
AGCGATGCGCCTAATA-1	Invasive
AGCGCATAATGAATCG-1	Healthy
AGCGCGGGTGCCAATG-1	Healthy
AGCGCTTATGGGCAAG-1	Healthy
AGCGGACACTTCGTAG-1	Tumor
AGCGGCGGTTAGCGGT-1	Invasive
AGCGGGAAGGGTCCAT-1	Invasive
AGCGGGTCTGACACTC-1	Surrounding tumor
AGCGGTTGCCGCTCTG-1	Healthy
AGCGTACGAGAGCTAG-1	Invasive
AGCGTCTGAACCCGCA-1	Invasive
AGCTAACAAGCAATGT-1	Invasive
AGCTAAGTACGCAGGC-1	Invasive
AGCTAGAAGCAGAAGT-1	Healthy
AGCTATTTAATCCAAC-1	Surrounding tumor
AGCTCCATATATGTTC-1	Tumor
AGCTCCTTCGCACATC-1	Invasive
AGCTCTAGACGTTCCA-1	Invasive
AGCTCTTCCCAGTGCA-1	Surrounding tumor
AGCTCTTCGTAACCTT-1	Tumor
AGCTCTTTACTCAGTT-1	Invasive
AGCTGAAGTAAACCAA-1	Surrounding tumor
AGCTGTAACCTCAATC-1	Invasive
AGCTTATAGAGACCTG-1	Surrounding tumor
AGCTTCTTCTCGAGCA-1	Invasive
AGCTTGATCTTAACTT-1	Surrounding tumor
AGGAAGCTGTCCGCCG-1	Tumor
AGGACATCGCACGTCG-1	Invasive
AGGACGACCCATTAGA-1	Invasive
AGGACGCTCGATGTTG-1	Healthy
AGGAGACATCCACAGT-1	Healthy
AGGAGGCCTTCGCGCG-1	Invasive
AGGATAAAGTCGGGAT-1	Tumor
AGGATATAGGGATTTA-1	Surrounding tumor
AGGATATCCGACTGCA-1	Invasive
AGGATCACGCGATCTG-1	Invasive
AGGATTGCTTACGACA-1	Surrounding tumor
AGGCACGTGACTGTCC-1	Tumor
AGGCAGATGCGTAAAC-1	Surrounding tumor
AGGCAGGGAGCGTACT-1	Invasive
AGGCATTGTCGTAGGG-1	Surrounding tumor
AGGCCACCCGTTATGA-1	Surrounding tumor
AGGCCCAGTGACTGGT-1	Invasive
AGGCCCATTGTACAGG-1	Invasive
AGGCCCTAGAACGCCA-1	Surrounding tumor
AGGCCTATCATACCAA-1	Invasive
AGGCCTGAGAATCTCG-1	Invasive
AGGCGGTTTGTCCCGC-1	Invasive
AGGCGTCTATGGACGG-1	Healthy
AGGCTATGGTTAGCTT-1	Surrounding tumor
AGGCTTGCTAGACACC-1	Surrounding tumor
AGGGAAACGAGGTACT-1	Surrounding tumor
AGGGACCGGCTGCGTT-1	Tumor
AGGGAGACATACTTCG-1	Surrounding tumor
AGGGCAGCGGCGTGGT-1	Tumor
AGGGCGAGCAGCTGAT-1	Surrounding tumor
AGGGCGTGATCGGCTA-1	Invasive
AGGGCTGCAGTTACAG-1	Invasive
AGGGTCAGAGCACTCG-1	Invasive
AGGGTCAGTAACCCTA-1	Healthy
AGGGTCGATGCGAACT-1	Surrounding tumor
AGGGTGCCGTTCTTTA-1	Invasive
AGGGTGCTCTCGAGGG-1	Healthy
AGGGTTCAGACGGTCC-1	Invasive
AGGGTTCCCTTTGGTT-1	Invasive
AGGGTTTAGTTCGGGA-1	Invasive
AGGTAACCTCCTATTC-1	Invasive
AGGTACGATATTGCCA-1	Surrounding tumor
AGGTAGATCGAGATAT-1	Invasive
AGGTAGGTACAAAGCT-1	Invasive
AGGTATAATTGATAGT-1	Tumor
AGGTCAGGTGAGAGTG-1	Surrounding tumor
AGGTCGCGGAGTTACT-1	Healthy
AGGTGCACGTCCACAT-1	Invasive
AGGTGGTGACCTTCGC-1	Tumor
AGGTGTATCGCCATGA-1	Surrounding tumor
AGGTTACACCATGCCG-1	Surrounding tumor
AGGTTCTCCTTTCCGG-1	Invasive
AGGTTGAGGCACGCTT-1	Invasive
AGGTTTCACACACCTT-1	Invasive
AGTAACGTTCATCCTG-1	Healthy
AGTAACTATAGCAGCC-1	Invasive
AGTAATCTAAGGGTGG-1	Surrounding tumor
AGTAATGTCTTGCCGC-1	Invasive
AGTAATTTGCAAGCGT-1	Invasive
AGTACAGAAGCTTATA-1	Invasive
AGTACATCATTTATCA-1	Surrounding tumor
AGTACCTTCGAGTGCT-1	Healthy
AGTACGGGCACCTGGC-1	Surrounding tumor
AGTACGTGGCCTGTCT-1	Surrounding tumor
AGTACTCTTATGCCCA-1	Invasive
AGTAGAAGGCGCCTCA-1	Invasive
AGTAGCGTGAACGAAC-1	Tumor
AGTAGGAAGGAAGTTG-1	Healthy
AGTAGGTAACATACAT-1	Invasive
AGTATAATACTAGGCA-1	Invasive
AGTATACACAGCGACA-1	Invasive
AGTATCCATAATAACG-1	Invasive
AGTATGCTGGAGACCA-1	Invasive
AGTCAAATGATGTGAT-1	Invasive
AGTCAACACCACCATC-1	Invasive
AGTCAAGATGACACTT-1	Surrounding tumor
AGTCACTAGCTCTCGA-1	Invasive
AGTCACTCCGCCTCAT-1	Invasive
AGTCAGCCACCGCCTG-1	Invasive
AGTCCAGCGGGTACGT-1	Invasive
AGTCCATTGGCTGATG-1	Tumor
AGTCCCGCCTTTAATT-1	Healthy
AGTCGACGGTCTCAAG-1	Invasive
AGTCGGCCCAAACGAC-1	Invasive
AGTCGGCTCAACTTTA-1	Surrounding tumor
AGTCGGTTGCGTGAGA-1	Tumor
AGTCGTATAAAGCAGA-1	Invasive
AGTCGTCGACCACCAA-1	Invasive
AGTCGTGGGCATTACG-1	Surrounding tumor
AGTCTAAAGTATACTC-1	Surrounding tumor
AGTCTCACAAGACTAC-1	Invasive
AGTCTGGACATCCTTG-1	Invasive
AGTCTTCTCCTCAAAT-1	Invasive
AGTCTTTAAAGTGTCC-1	Invasive
AGTGAACAAACTTCTC-1	Tumor
AGTGAAGATGGTGTCC-1	Healthy
AGTGACCTACTTTACG-1	Invasive
AGTGACTGTGACACAA-1	Invasive
AGTGAGACTTCCAGTA-1	Healthy
AGTGAGCCTCGCCGCC-1	Surrounding tumor
AGTGAGGGTTTCTGAC-1	Surrounding tumor
AGTGAGTCGAATTAAC-1	Invasive
AGTGATAACCTGCGCG-1	Invasive
AGTGATATGAGTAGTT-1	Invasive
AGTGATTCAAGCAGGA-1	Healthy
AGTGCACGCTTAAGAA-1	Invasive
AGTGCGTAGCTCGTAA-1	Invasive
AGTGCTAAACACAGCA-1	Invasive
AGTGCTTGCACGAATA-1	Invasive
AGTGGCCCGCAAATGG-1	Invasive
AGTGGCGGCAATTTGA-1	Healthy
AGTGGCGTCTGAAGGT-1	Invasive
AGTGGCTCCGTCGGCC-1	Surrounding tumor
AGTGTATTGCGCATTG-1	Healthy
AGTGTGGTCTATTGTG-1	Invasive
AGTTAAACACTTGCGA-1	Invasive
AGTTAAGCGGTCCCGG-1	Surrounding tumor
AGTTAAGTCAACCGCT-1	Invasive
AGTTACCGCACATGGT-1	Surrounding tumor
AGTTACTCTATCGTGG-1	Surrounding tumor
AGTTATTCAGACTGTG-1	Invasive
AGTTCCTACAGAATTA-1	Surrounding tumor
AGTTCCTATTTATGTT-1	Healthy
AGTTCTGCGTTGTATC-1	Invasive
AGTTGACATCGGCTGG-1	Invasive
AGTTGACGGTCCTTGC-1	Tumor
AGTTGCGGTCCTCAAC-1	Invasive
AGTTGCTGACTGATAT-1	Invasive
AGTTGGCAAGGCTAGA-1	Invasive
AGTTTATGTAAAGACA-1	Healthy
AGTTTCGCAGGTCGGA-1	Surrounding tumor
AGTTTGCACCTGCCTC-1	Tumor
AGTTTGGCACGGGTTG-1	Surrounding tumor
AGTTTGGCCAGACCTA-1	Invasive
ATAAACGGACCCGTAA-1	Healthy
ATAAACGTTGCACCAC-1	Tumor
ATAAAGGCTCGGTCGT-1	Invasive
ATAAAGGTCAAGTACG-1	Surrounding tumor
ATAAATATTAGCAGCT-1	Invasive
ATAACGCCGGAGGGTC-1	Invasive
ATAACGGAGTCCAACG-1	Invasive
ATAACGTTACCTCCAC-1	Healthy
ATAAGGTGGAGAACAT-1	Healthy
ATAAGTACCCGATTGT-1	Healthy
ATAAGTAGGATTCAGA-1	Surrounding tumor
ATAAGTAGGGCGACTC-1	Tumor
ATAAGTTACCGCGACG-1	Invasive
ATAATACCGTTAGCCG-1	Invasive
ATAATAGCTGTTGAAT-1	Healthy
ATAATAGTGTAGGGAC-1	Invasive
ATAATCTTGGAGAACC-1	Tumor
ATAATTAGCTAAGTAG-1	Tumor
ATACAGGCCCTCCAAT-1	Tumor
ATACCACGGGCAACTT-1	Invasive
ATACCAGCAAATTGCT-1	Tumor
ATACCAGGCTAATAGA-1	Invasive
ATACCAGGTGAGCGAT-1	Tumor
ATACCGTCATCCATAA-1	Healthy
ATACCTAACCAAGAAA-1	Tumor
ATACGCCGGCGAAACC-1	Invasive
ATACGGAACGTCGTTT-1	Invasive
ATACGGGTTTCGATTG-1	Surrounding tumor
ATACGTACTTAGCCAC-1	Tumor
ATACGTCCACTCCTGT-1	Surrounding tumor
ATACGTTATGCACGGA-1	Tumor
ATACTACCCGTACCAC-1	Surrounding tumor
ATACTAGCATGACCCT-1	Invasive
ATACTCTCGCCACTCT-1	Invasive
ATACTGCCTTACACCG-1	Tumor
ATAGACAACGGGACCT-1	Healthy
ATAGACGAAGAGAAAG-1	Invasive
ATAGAGTACTGGGACA-1	Invasive
ATAGAGTTATCAACTT-1	Healthy
ATAGATTTGCAGTCGG-1	Tumor
ATAGCAACTAGGGAAG-1	Invasive
ATAGCCATAACAGTCA-1	Invasive
ATAGCCTCAGTACCCA-1	Invasive
ATAGGAATCTAAGCTT-1	Surrounding tumor
ATAGGCGGCTATAGAA-1	Invasive
ATAGGCTAGCTTCGCA-1	Healthy
ATAGGGATATCCTTGA-1	Invasive
ATAGGTTGGGCAGATG-1	Invasive
ATAGTCTTTGACGTGC-1	Tumor
ATAGTGAAGCGTTCTC-1	Invasive
ATAGTTCCACCCACTC-1	Tumor
ATATAAAGCGCTCGTG-1	Tumor
ATATAAATGTAGCTGC-1	Tumor
ATATAACACGGGCGCA-1	Invasive
ATATACGCTCGTGACG-1	Surrounding tumor
ATATAGAGTATTGGTC-1	Invasive
ATATCAACCTACAGAG-1	Tumor
ATATCGGTAGGGAGAT-1	Tumor
ATATCGTGCCAGACCC-1	Tumor
ATATCGTTCCTCGAAC-1	Invasive
ATATCTCCCTCGTTAA-1	Surrounding tumor
ATATCTTAGGGCCTTC-1	Invasive
ATATGGGATAGCAACT-1	Invasive
ATATGTCTAGAGCGTG-1	Invasive
ATATGTCTCCCTAGCC-1	Surrounding tumor
ATATGTGCACAAACCA-1	Healthy
ATATTCAGTTAAACCT-1	Invasive
ATATTCCACATAGTGA-1	Surrounding tumor
ATATTCCCACAGGTCA-1	Invasive
ATATTGCTGTCAAAGT-1	Invasive
ATATTTAACCCTCAAG-1	Invasive
ATCAAACACTGTTCCA-1	Surrounding tumor
ATCAAACGAAGGTTTG-1	Surrounding tumor
ATCAAGATCCCAGGAC-1	Invasive
ATCAATCTGGGCTGCA-1	Invasive
ATCAATGCCGTGGCTG-1	Invasive
ATCACATTAGAATATC-1	Surrounding tumor
ATCACGTGCTAATTAA-1	Invasive
ATCACTTCATCCTCGC-1	Invasive
ATCAGACGGCACGCCG-1	Invasive
ATCAGCCTCATGCTGC-1	Invasive
ATCAGCTCGTCCACTA-1	Invasive
ATCAGGTCGCCATTGC-1	Healthy
ATCAGTAGGCAGGGAT-1	Surrounding tumor
ATCATAGCCCTATGTA-1	Invasive
ATCATCCAATATTTGT-1	Invasive
ATCATCTGCCCAGTGT-1	Surrounding tumor
ATCCAACGCAGTCATA-1	Invasive
ATCCAATGGAGGGTCC-1	Invasive
ATCCACATCGACAGAA-1	Tumor
ATCCACGCTAAATGTT-1	Surrounding tumor
ATCCACTTTCAGACTA-1	Healthy
ATCCAGGATTCGTGAA-1	Invasive
ATCCCATCCACAGCGC-1	Invasive
ATCCCATTTCCGTGGG-1	Invasive
ATCCTACCTAAGCTCT-1	Invasive
ATCCTGAATCGCTGCG-1	Invasive
ATCCTGCGTGGAATGG-1	Invasive
ATCCTGCTGCAGATAG-1	Surrounding tumor
ATCGACCCAATACAGA-1	Invasive
ATCGACTCTTTCCGTT-1	Invasive
ATCGCACGATTGTTCA-1	Invasive
ATCGCACGCCGGGAGA-1	Invasive
ATCGCCAGTCAACATT-1	Tumor
ATCGCTGCGTGCAGCA-1	Healthy
ATCGGAGACAGACGGC-1	Tumor
ATCGGCAAGCAGTCCA-1	Healthy
ATCGTCCAATCGAGTC-1	Invasive
ATCGTGGAAAGTCTGG-1	Invasive
ATCGTTAGCTAGCGGA-1	Invasive
ATCGTTCACTTTCGCC-1	Healthy
ATCTAATATCCTACGG-1	Tumor
ATCTACCATCTGCTCC-1	Invasive
ATCTAGCTTGTGAGGG-1	Surrounding tumor
ATCTCCCACGGAATAT-1	Surrounding tumor
ATCTCCCTGCAATCTA-1	Surrounding tumor
ATCTCGTGAGCGAAAC-1	Surrounding tumor
ATCTGACATGGAAGGA-1	Invasive
ATCTGCACCTCTGCGA-1	Surrounding tumor
ATCTGCTGTTATCGCC-1	Invasive
ATCTGGGCTGTTCTTG-1	Tumor
ATCTGGTTAAGACTGT-1	Invasive
ATCTGTAATTGTACCC-1	Invasive
ATCTTAGGGCATTAAT-1	Invasive
ATCTTATCGCACACCC-1	Invasive
ATCTTGACCTGCAACG-1	Invasive
ATCTTGACTTGTCCAA-1	Surrounding tumor
ATCTTTCGTATAACCA-1	Healthy
ATGAAGCCAAGGAGCC-1	Invasive
ATGACGCCGGCTCTAA-1	Invasive
ATGACGCGTTCTATCC-1	Surrounding tumor
ATGACTATCAGCTGTG-1	Invasive
ATGACTATGCGACATT-1	Surrounding tumor
ATGAGGAGTGTTAATC-1	Surrounding tumor
ATGAGGGCAGCGGCTA-1	Surrounding tumor
ATGATCGGGAATAGAC-1	Invasive
ATGATGCAATGGTACA-1	Invasive
ATGCACGCGCTGTTCA-1	Invasive
ATGCACTACCGCATTG-1	Invasive
ATGCATGATCCAGGAT-1	Invasive
ATGCATTCCGTGATGG-1	Tumor
ATGCCAATCGCTCTGC-1	Healthy
ATGCCATTTGCGACCA-1	Invasive
ATGCCGGTCTTGCATA-1	Invasive
ATGCCGGTTGATGGGA-1	Surrounding tumor
ATGCGACAATTGGTCC-1	Healthy
ATGCGACAGTCCCATT-1	Invasive
ATGCGAGTCCCACCAC-1	Surrounding tumor
ATGCTCAGTGTTGCAT-1	Invasive
ATGCTCTGGCGCGGTA-1	Tumor
ATGCTTAGGAGTTGAT-1	Tumor
ATGGAACCTTTGCACA-1	Tumor
ATGGAGCAGGCCGTGA-1	Invasive
ATGGATCCGGCGTCCG-1	Surrounding tumor
ATGGATTGACCAAACG-1	Invasive
ATGGCAGCATTACGAT-1	Invasive
ATGGCTGGAAATGGCC-1	Healthy
ATGGGAACGGAAGCGG-1	Healthy
ATGGGACCTGCTGAAC-1	Invasive
ATGGGCCTCGGCCTCT-1	Surrounding tumor
ATGGGTGTATACCTCC-1	Invasive
ATGGTATTGGGAACCG-1	Invasive
ATGGTATTTACTGATT-1	Invasive
ATGGTCGCGTGGTTTC-1	Invasive
ATGGTGCTCAAAGCCA-1	Tumor
ATGGTTACGAAACATG-1	Healthy
ATGTAAGGCTGCTCTT-1	Tumor
ATGTACATGCGGTGAG-1	Surrounding tumor
ATGTACGATGACGTCG-1	Surrounding tumor
ATGTAGCGCGCGTAGG-1	Invasive
ATGTGAAAGCCTAATG-1	Surrounding tumor
ATGTGCATCCGACGCA-1	Invasive
ATGTGTAGTTTAGTCA-1	Tumor
ATGTTACGAGCAATAC-1	Invasive
ATGTTGATTAGAGACT-1	Invasive
ATGTTGTAGTCTGTTT-1	Invasive
ATTAAACATGCGGACC-1	Invasive
ATTAATACTACGCGGG-1	Invasive
ATTAATGAACCAGTCG-1	Surrounding tumor
ATTAATTCGGTCACTC-1	Surrounding tumor
ATTACAACTACCGGCC-1	Surrounding tumor
ATTACATGTCAGTCTT-1	Surrounding tumor
ATTACCACACTGCCTG-1	Surrounding tumor
ATTACGACTCCACAGT-1	Healthy
ATTACGCGCTGGCAGG-1	Invasive
ATTACTAGCCTCTTGC-1	Invasive
ATTACTTACTGGGCAT-1	Healthy
ATTAGATTCCTCAGCA-1	Healthy
ATTAGATTGATAGCGG-1	Invasive
ATTAGGCGATGCTTTC-1	Invasive
ATTATACTTTGCTCGT-1	Surrounding tumor
ATTATAGCTACTTTAC-1	Tumor
ATTATCGGAATGTACG-1	Invasive
ATTATCTCGACAGATC-1	Tumor
ATTATGAGACCCAATT-1	Invasive
ATTATGCCATAGGGAG-1	Invasive
ATTATTATGTCCGTCA-1	Invasive
ATTATTCAGAGTCACT-1	Invasive
ATTCAACCATTTAAGG-1	Surrounding tumor
ATTCACTGATGTTGGA-1	Tumor
ATTCAGGACCTATTTC-1	Healthy
ATTCAGTAGCAGGGTC-1	Surrounding tumor
ATTCATATACTGTCCA-1	Surrounding tumor
ATTCATCGTTGAGGCA-1	Invasive
ATTCCCACATAAACAA-1	Surrounding tumor
ATTCCTAAGACGTGGA-1	Healthy
ATTCCTCCGCCAGTGC-1	Invasive
ATTCCTTCCAGGCGGT-1	Invasive
ATTCGACGCCGGGCCT-1	Invasive
ATTCGCGCCTTGAGAG-1	Invasive
ATTCGTGCTATCTCTT-1	Tumor
ATTCGTTTATCGTATT-1	Invasive
ATTCTCGTCTCTTTAG-1	Invasive
ATTCTGAGTATGAACT-1	Surrounding tumor
ATTCTTCGTACTTATG-1	Surrounding tumor
ATTGAAGATCTTAGTG-1	Invasive
ATTGACCGGCGATGAC-1	Healthy
ATTGACGTAACTCGGT-1	Tumor
ATTGATAGCAACGAGA-1	Invasive
ATTGATGAGTCCTAAC-1	Surrounding tumor
ATTGCCTATTAGACCG-1	Invasive
ATTGCCTTTATGTTTG-1	Invasive
ATTGCGATCAGTAACT-1	Surrounding tumor
ATTGCTGCTCCTCCAT-1	Invasive
ATTGGATTACAGCGTA-1	Surrounding tumor
ATTGGGAATATCTTGG-1	Invasive
ATTGGGAGTTCTGTAA-1	Healthy
ATTGGTTGTGCATTAC-1	Invasive
ATTGTACAACTCGGCT-1	Tumor
ATTGTCGCAATACCTT-1	Surrounding tumor
ATTGTCTGTTTCATGT-1	Invasive
ATTGTGACTTCGCTGC-1	Healthy
ATTTAACTCGTATTAC-1	Invasive
ATTTACAGTTTACTGG-1	Invasive
ATTTACTAAGTCCATT-1	Surrounding tumor
ATTTATACTGGTAAAG-1	Invasive
ATTTCATTATTTCGCG-1	Surrounding tumor
ATTTCCGGGTTCTGCG-1	Invasive
ATTTGCCTAGTTACGA-1	Tumor
ATTTGCGCGAGTAGCT-1	Surrounding tumor
ATTTGTCTTGGGAGCT-1	Invasive
ATTTGTTCCAGGGCTC-1	Invasive
CAAACCCTCCGGCGGG-1	Invasive
CAAACGAGTATCGCAG-1	Invasive
CAAACGGTCGCACTTT-1	Invasive
CAAACGTGGTCTTGCG-1	Tumor
CAAACTACGATAGAGA-1	Surrounding tumor
CAAACTATTGAGCTTC-1	Tumor
CAAACTCGCGACGCCG-1	Surrounding tumor
CAAAGATTATTGGGCC-1	Invasive
CAAAGGTTAAATTCAG-1	Healthy
CAAATCTCTCACAAGG-1	Surrounding tumor
CAAATGCGGAGTGTTC-1	Tumor
CAAATGTCCTTCCGTG-1	Invasive
CAAATTGGATTATGCC-1	Healthy
CAAATTGTCAGCAAGC-1	Surrounding tumor
CAACACATCTCCTGCC-1	Surrounding tumor
CAACAGTGCCAAACGG-1	Tumor
CAACCAGTGGCCTACC-1	Tumor
CAACCTACCGAGCAGT-1	Invasive
CAACCTGAACCTGCCA-1	Healthy
CAACGACCCGTTTACA-1	Invasive
CAACGGTTCTTGATAC-1	Invasive
CAACGTGGTGGAGTCT-1	Surrounding tumor
CAACTATATCGAATGC-1	Surrounding tumor
CAACTCCAACGTTTAG-1	Surrounding tumor
CAACTCCGTAACTTGC-1	Healthy
CAACTCCTTGATCCCG-1	Invasive
CAACTGAGGGTATGAC-1	Healthy
CAACTGCTCATCCGAT-1	Tumor
CAACTTGTAGTGGGCA-1	Invasive
CAAGAAACCCTAAACT-1	Healthy
CAAGATATTATAACGT-1	Invasive
CAAGCAACGTCGGAGT-1	Invasive
CAAGCACCAAATGCCT-1	Invasive
CAAGCGGCACATAATT-1	Tumor
CAAGGATCGCATGTTC-1	Invasive
CAAGGCCAGTGGTGCA-1	Invasive
CAAGGTCCTATAGGCT-1	Tumor
CAAGTAAGTGATAGAC-1	Invasive
CAAGTGAACTTTGGTT-1	Surrounding tumor
CAAGTGTGGTTGCAAA-1	Surrounding tumor
CAATAAACCTTGGCCC-1	Invasive
CAATACGAGAGTCTGA-1	Surrounding tumor
CAATACGCTCTGAGGC-1	Surrounding tumor
CAATATGTAGATTTAC-1	Healthy
CAATATTGGACTAGTG-1	Invasive
CAATCCCTATACCAGC-1	Surrounding tumor
CAATCCTGCCGTGGAG-1	Invasive
CAATGACCCTTAATTT-1	Invasive
CAATGAGGTTCGACTA-1	Surrounding tumor
CAATGCGAGAAGTATC-1	Tumor
CAATGGAATCTACATA-1	Healthy
CAATGGATCTCTACCA-1	Surrounding tumor
CAATGGTCGGCCTGGG-1	Surrounding tumor
CAATGTGCCAACCCTT-1	Tumor
CAATTAAGGGTGATGA-1	Invasive
CAATTTCGTATAAGGG-1	Invasive
CAATTTGACCGGGAAG-1	Invasive
CACAAACCGCAGAACT-1	Invasive
CACAAGAAAGATATTA-1	Healthy
CACAAGCTAAGAAAGG-1	Invasive
CACAATGAGCTGCTAT-1	Invasive
CACACACGCTAACGAG-1	Surrounding tumor
CACACAGCTTGCGCTC-1	Surrounding tumor
CACACAGGGATAGATT-1	Surrounding tumor
CACACGCGCTGTCTTA-1	Healthy
CACACGTTTCAATGGG-1	Healthy
CACACTTGTATTGCGA-1	Healthy
CACAGAGACGAGGACG-1	Invasive
CACAGCACCCACGGCA-1	Invasive
CACAGCTAGGGAGTGA-1	Invasive
CACAGGGCCATATAGT-1	Invasive
CACAGGGCCGTTGTCA-1	Tumor
CACAGTCCCGCTTCGC-1	Tumor
CACAGTTCGCTTCCCA-1	Surrounding tumor
CACATCGTGCACGCGC-1	Invasive
CACATCTCACCGACGA-1	Tumor
CACATGATTCAGCAAC-1	Invasive
CACATGTTTGGACATG-1	Invasive
CACATTCTTTCGATGG-1	Surrounding tumor
CACATTTCTTGTCAGA-1	Tumor
CACCAGTCAGCATGCA-1	Invasive
CACCATCGGAGGAGAC-1	Surrounding tumor
CACCATGATCGCAAAG-1	Healthy
CACCCAAATCTTATGT-1	Tumor
CACCCACACGTCACCC-1	Invasive
CACCCACGAGGCAATT-1	Surrounding tumor
CACCCGCGTTTGACAC-1	Invasive
CACCCTAACAAGATCT-1	Tumor
CACCCTTGGTGAGACC-1	Invasive
CACCCTTTCCTCGCTC-1	Invasive
CACCGATACACCGAGC-1	Surrounding tumor
CACCGATGATGGGTAC-1	Invasive
CACCGCCAGAAGGTTT-1	Invasive
CACCGCCGACCAGCGA-1	Tumor
CACCGCGTCCACTCTA-1	Healthy
CACCGGAGATATCTCC-1	Healthy
CACCGGGCATCACAAG-1	Invasive
CACCGGTAGAGACATT-1	Invasive
CACCGTATCCCATCCG-1	Surrounding tumor
CACCGTTGCGCGATAT-1	Surrounding tumor
CACCTAATAGAGTCGT-1	Invasive
CACCTAATCAGTTTAC-1	Invasive
CACCTCGATGGTGGAC-1	Invasive
CACCTTGCGAAACTCG-1	Surrounding tumor
CACCTTGGCGCCTTTG-1	Tumor
CACGAAAGTTAGTCCC-1	Invasive
CACGACGTAATAGTAA-1	Healthy
CACGATTGGTCGTTAA-1	Surrounding tumor
CACGCACAGCGCAGCT-1	Invasive
CACGCAGCGAGGCTTT-1	Invasive
CACGCGGAACTGTTGC-1	Tumor
CACGGACGTGGATGGC-1	Healthy
CACGGCGCGCCAAAGG-1	Healthy
CACGTCAATCAATGGA-1	Surrounding tumor
CACGTCGGCAACCTCT-1	Surrounding tumor
CACGTCTATGATGTGG-1	Healthy
CACGTTCGTGCTCTAG-1	Invasive
CACGTTTCGTACACAC-1	Invasive
CACTAAAGTTGCCTAT-1	Invasive
CACTACGGGAGCTGCC-1	Surrounding tumor
CACTACTCAGTTCTGT-1	Tumor
CACTCAAGAGCTATGG-1	Invasive
CACTCAGCTCTTGAGG-1	Tumor
CACTCCTATGTAAGAT-1	Invasive
CACTCCTCTCGGTCGG-1	Surrounding tumor
CACTCGAGCTGAACAA-1	Healthy
CACTCTCAAGCATCGA-1	Invasive
CACTCTTCTGCTAGCC-1	Surrounding tumor
CACTGACGATTGTGGA-1	Invasive
CACTGTCCAAGTGAGA-1	Invasive
CACTTAATCAGACGGA-1	Invasive
CACTTCGCCACAGGCT-1	Invasive
CACTTCGTCTTATCTC-1	Invasive
CAGAACTTAGCCCTCT-1	Invasive
CAGAATAACACACGGA-1	Surrounding tumor
CAGACCTGTAAGTGTT-1	Surrounding tumor
CAGAGCATGAGCTTGC-1	Invasive
CAGAGTGATTTAACGT-1	Tumor
CAGATAATGGGCGGGT-1	Invasive
CAGATACTAACATAGT-1	Invasive
CAGATATGAAGATGAC-1	Invasive
CAGATCATTTAAAGTC-1	Healthy
CAGATCCTGGTTTGAA-1	Invasive
CAGCAGCCCGTTCCTT-1	Invasive
CAGCAGTCCAGACTAT-1	Surrounding tumor
CAGCAGTCTGTGCTGC-1	Tumor
CAGCCCTCACAGGCAG-1	Tumor
CAGCCGGGCCCTCTAT-1	Surrounding tumor
CAGCCTCCTGCAGAGG-1	Surrounding tumor
CAGCCTCTCCTCAAGA-1	Healthy
CAGCTCACTGAGACAT-1	Invasive
CAGCTCGACAAGTTAA-1	Healthy
CAGCTCGTGCTTGTGT-1	Invasive
CAGCTGGCGTAACCGT-1	Surrounding tumor
CAGCTTAGTAGGTAGC-1	Invasive
CAGGAAGACTTTATAT-1	Surrounding tumor
CAGGATATATCGTTGT-1	Invasive
CAGGCAGTCTTACCAG-1	Invasive
CAGGCCAGTACCACCT-1	Invasive
CAGGCCGTTTGGGTGT-1	Invasive
CAGGCGCACGGTGGTC-1	Invasive
CAGGCGCCATGCTAGG-1	Healthy
CAGTAACTATTTATTG-1	Healthy
CAGTAATCCCTCCCAG-1	Invasive
CAGTACATTCTCTAAA-1	Healthy
CAGTACCAGTTTACGT-1	Invasive
CAGTAGCCCACGCGGT-1	Healthy
CAGTAGCGAGGTAGTA-1	Invasive
CAGTCCAACGCCTTCT-1	Healthy
CAGTCGAGGATGCAAT-1	Healthy
CAGTCTCTCGGCTAAT-1	Invasive
CAGTCTGTATACTGGG-1	Invasive
CAGTGAATAAATGACT-1	Surrounding tumor
CAGTGGTTGCACATGA-1	Invasive
CAGTGTCCGCAGAATG-1	Invasive
CAGTGTCGGCTGGCCC-1	Invasive
CAGTGTTAATCTCTCA-1	Invasive
CAGTTCAAATTGACAC-1	Invasive
CAGTTCCGCGGGTCGA-1	Surrounding tumor
CAGTTCGAGGACCCGA-1	Invasive
CATAACGGACAGTCGT-1	Invasive
CATAAGAAGCTTGGCT-1	Tumor
CATAAGCTCTCCGTCT-1	Surrounding tumor
CATAATGAGCGGGCGA-1	Surrounding tumor
CATACAAAGCCGAACC-1	Invasive
CATACACGGTTCCCAC-1	Tumor
CATACCCGTACCCAGT-1	Invasive
CATACGAACTAGCTGG-1	Invasive
CATACGGCGTCTGGGC-1	Invasive
CATACGGGTGCATGAT-1	Invasive
CATACTATGTAATTGT-1	Invasive
CATACTTAGGCAATAC-1	Tumor
CATACTTCTTTCTCCG-1	Invasive
CATAGAGGAGATACTA-1	Invasive
CATAGCCGCCCGGGAT-1	Surrounding tumor
CATAGTACATTGAGAG-1	Surrounding tumor
CATAGTAGCATAGTAG-1	Invasive
CATAGTCAAATACATA-1	Invasive
CATAGTCCACAAGAAC-1	Invasive
CATATACTACTGATAA-1	Healthy
CATATAGGTACAGTCA-1	Invasive
CATATGTCAGGCTACG-1	Surrounding tumor
CATATTATTTGCCCTA-1	Tumor
CATCAAACTGGCGCCC-1	Healthy
CATCATCTACCCGGAC-1	Tumor
CATCATTACCCTGAGG-1	Invasive
CATCCAATATAGTTTG-1	Invasive
CATCCCGAGATTCATA-1	Invasive
CATCCGCAGGCCCGAA-1	Invasive
CATCCTCTCAAAGATC-1	Invasive
CATCGCCCGCGGCCAA-1	Invasive
CATCGGACGGGTTAAT-1	Invasive
CATCTACCCGAGAACG-1	Healthy
CATCTATCCCGTGTCT-1	Healthy
CATCTTACACCACCTC-1	Tumor
CATGAACCGACATTTG-1	Invasive
CATGAACCTCTTATCA-1	Tumor
CATGACTTCGCTGAAT-1	Tumor
CATGAGATGCACTCTC-1	Tumor
CATGATCGCTTTGAGA-1	Invasive
CATGATGCACAATTCT-1	Invasive
CATGATGGAAGTTAGC-1	Tumor
CATGCATGGAGACCCT-1	Tumor
CATGCCAACTCGCAAA-1	Surrounding tumor
CATGCGACCAGTTTAA-1	Healthy
CATGCGTTAGACAGAA-1	Invasive
CATGCGTTGAGAGGAG-1	Invasive
CATGCTGGCTCCAATT-1	Invasive
CATGGAAATGGGACCA-1	Healthy
CATGGATTGTCTTCCG-1	Surrounding tumor
CATGGCAGGAAGATCG-1	Invasive
CATGGGTATGCCTTAT-1	Tumor
CATGGGTCGGGTGTGG-1	Surrounding tumor
CATGGTCTAGATACCG-1	Invasive
CATGGTTTATTAATCA-1	Invasive
CATGTAAGAGACATTT-1	Invasive
CATGTAGGAGCGCCAA-1	Healthy
CATGTCTCATTTATGG-1	Surrounding tumor
CATTACATAGATTGTG-1	Surrounding tumor
CATTACGCAGGAAGGG-1	Invasive
CATTACGTCGGCCCGT-1	Invasive
CATTATAACAGGGTCC-1	Tumor
CATTATCCCATTAACG-1	Invasive
CATTATGCTTGTTGTG-1	Invasive
CATTCACTGACAGCTA-1	Tumor
CATTCAGGTCAGTGCG-1	Invasive
CATTCCCATTCCGTCG-1	Surrounding tumor
CATTCCCTAAGTACAA-1	Invasive
CATTGATGAACACGCC-1	Healthy
CATTGCGGGTCAATTC-1	Healthy
CATTGTGTGCTAGATC-1	Invasive
CATTTAGCGGACCATG-1	Surrounding tumor
CATTTATCGTTCAAGA-1	Tumor
CATTTCTAGCAGACTA-1	Invasive
CCAAACAGAACCCTCG-1	Invasive
CCAAATAACAAGATTC-1	Surrounding tumor
CCAAATCAAAGGGCAA-1	Invasive
CCAACCTTATGTAACT-1	Invasive
CCAACGATGCACTGAT-1	Invasive
CCAACGCTTGCCAGGG-1	Healthy
CCAAGACTTCTGCGAA-1	Invasive
CCAAGCGTAACTCGTA-1	Invasive
CCAAGGAACAGAGAGG-1	Invasive
CCAAGGTTGCCCTTTC-1	Invasive
CCAATAGTGCCGTCGA-1	Invasive
CCAATCGGTAGATCGA-1	Surrounding tumor
CCAATGTCACAGCAAG-1	Invasive
CCAATTACGGGTCGAG-1	Healthy
CCAATTGAATGTTAAT-1	Invasive
CCACAATGTACGTCTT-1	Invasive
CCACACTGAGATATTA-1	Invasive
CCACAGCTGAAATCAT-1	Invasive
CCACAGTACCCATCCT-1	Surrounding tumor
CCACATACTGCACCCA-1	Surrounding tumor
CCACCCAAGGAAAGTG-1	Invasive
CCACGAATTTAACCTC-1	Tumor
CCACGAGAAGAGAATC-1	Surrounding tumor
CCACGGAGCCATAAGA-1	Surrounding tumor
CCACGGTGCCCGGTAG-1	Tumor
CCACTAAACTGAATCG-1	Invasive
CCACTATCCGGGTCAC-1	Surrounding tumor
CCACTCAGATCCGCAA-1	Invasive
CCACTGGTGGCTGGTT-1	Surrounding tumor
CCACTGTTTGGATTAA-1	Tumor
CCAGAAACTGATGCGA-1	Invasive
CCAGAGACAAAGCCGG-1	Surrounding tumor
CCAGATAGTTGAGTGA-1	Invasive
CCAGCCTGGACCAATA-1	Invasive
CCAGCTACGCCTCATA-1	Invasive
CCAGCTCGAACGCATT-1	Tumor
CCAGCTGATGGTACTT-1	Invasive
CCAGCTTCCGCCCGCA-1	Surrounding tumor
CCAGGGACGTGGCCTC-1	Invasive
CCAGTAGTCTGATCCA-1	Healthy
CCAGTCCATTATTCGA-1	Invasive
CCAGTCTAGACGGCGC-1	Surrounding tumor
CCAGTCTTGTCATAGA-1	Tumor
CCAGTGTACAGACCGA-1	Invasive
CCAGTTCGGTAACTCA-1	Surrounding tumor
CCATAAACAACCCGAC-1	Surrounding tumor
CCATACCTTTACTTGT-1	Surrounding tumor
CCATAGGTTGGCGTGG-1	Invasive
CCATAGTCAGTAACCC-1	Invasive
CCATATGGAAACTATA-1	Surrounding tumor
CCATATTGGATCATGA-1	Invasive
CCATCCATACCAAGTC-1	Invasive
CCATCTCACCAGTGAA-1	Tumor
CCATCTTGTTCACAAT-1	Invasive
CCATGCCCTAGATTTC-1	Invasive
CCATGCCTGTTTAGTA-1	Invasive
CCATGCTCTGCAGGAA-1	Invasive
CCATGGCCCTTGTACC-1	Invasive
CCATGTTCATCTATAT-1	Invasive
CCATTAGCGATAATCC-1	Invasive
CCATTCCCTGCCCACA-1	Invasive
CCATTGTTTCCTCCAT-1	Surrounding tumor
CCATTTCTACCTATTA-1	Tumor
CCCAAACATGCTGCTC-1	Healthy
CCCAACATACGTCGCG-1	Invasive
CCCAACCACACTAACA-1	Tumor
CCCAAGACAGAGTATG-1	Tumor
CCCAAGTCATTACACT-1	Invasive
CCCAATGAGATTTGCA-1	Invasive
CCCAATTTCACAACTT-1	Invasive
CCCAGAGGAGGGCGTA-1	Healthy
CCCAGGAAGAATTCGA-1	Invasive
CCCAGGTCTGAAGGCT-1	Surrounding tumor
CCCAGTAAACTTGGGA-1	Invasive
CCCAGTTAAGGCGCCG-1	Invasive
CCCATATAGGTCGATT-1	Surrounding tumor
CCCGAAGTTTCGCGAA-1	Surrounding tumor
CCCGACCATAGTCCGC-1	Invasive
CCCGAGTTTCTCCGTA-1	Surrounding tumor
CCCGCAGCGCGAACTA-1	Healthy
CCCGCAGGGCCCAAAG-1	Tumor
CCCGCCATGCTCCCGT-1	Invasive
CCCGCGCAATGCACCC-1	Invasive
CCCGGGTCGTTCAGGG-1	Tumor
CCCGGTGGAAGAACCT-1	Surrounding tumor
CCCGGTGTATCGGAAT-1	Invasive
CCCGTAAGTCTAGGCC-1	Invasive
CCCGTAGCTGGGAAGA-1	Invasive
CCCGTCAGCGTCTGAC-1	Invasive
CCCGTTTCGCAGATGT-1	Surrounding tumor
CCCTACCCACACCCAG-1	Surrounding tumor
CCCTACTTGAACAATG-1	Invasive
CCCTAGTGTCAGGTGT-1	Invasive
CCCTATGTAGAGCAGA-1	Invasive
CCCTCATTCTGGAATT-1	Invasive
CCCTCCTCGCTCGTAT-1	Surrounding tumor
CCCTCGATAATACACA-1	Invasive
CCCTCGGGAGCCTTGT-1	Tumor
CCCTGAAATGAGTTGA-1	Invasive
CCCTGACTAACAAATT-1	Surrounding tumor
CCCTGATGTAACTCGT-1	Invasive
CCCTGCCCAATCCGCT-1	Surrounding tumor
CCCTGCGCTACGCATA-1	Invasive
CCCTGGTATGGGCGGC-1	Tumor
CCCTTTAATGGAGTTC-1	Invasive
CCGAAAGTGGTGAGCA-1	Invasive
CCGAACACTGGGCCTC-1	Surrounding tumor
CCGAACCTTCCCGGCC-1	Healthy
CCGAAGTATATTGTTC-1	Invasive
CCGACAAACACATGAG-1	Invasive
CCGACAAAGGGAGTGC-1	Invasive
CCGACAATAGGCCGCC-1	Tumor
CCGACGGGCATGAGGT-1	Surrounding tumor
CCGACGTAAACACAAC-1	Healthy
CCGACTCGCATAGTCT-1	Tumor
CCGAGAAGTCGCATAA-1	Surrounding tumor
CCGAGCTGTGCTTGTC-1	Healthy
CCGAGGGATGTTAGGC-1	Tumor
CCGATCTCAACCTTAT-1	Tumor
CCGATCTTAAGAGGCT-1	Healthy
CCGATTCGAGGGACCC-1	Surrounding tumor
CCGCACAAAGACCAAC-1	Invasive
CCGCACGTGACCTCGG-1	Invasive
CCGCACTTGCAATGAC-1	Invasive
CCGCATGTGGTACGAT-1	Tumor
CCGCCACCACAATCCA-1	Tumor
CCGCCGGAACTTCTCG-1	Invasive
CCGCCGGTCAACACAC-1	Invasive
CCGCCGTTGAGGATAA-1	Surrounding tumor
CCGCCTGCGAATTGGT-1	Healthy
CCGCGGGTACGAAGAA-1	Invasive
CCGCGTAGGTAAGGGC-1	Invasive
CCGCTATCAGCACCAG-1	Healthy
CCGCTCCAGGGCGATC-1	Surrounding tumor
CCGCTCTTCCGAACTA-1	Invasive
CCGCTGGTGCCATTCA-1	Tumor
CCGCTTACCTCACTCT-1	Invasive
CCGCTTGCTGACATGG-1	Surrounding tumor
CCGGAAGTGCAATATG-1	Invasive
CCGGAATGGTTTCAGT-1	Invasive
CCGGAGCGTACTTTCT-1	Tumor
CCGGAGGTCTTATGGT-1	Healthy
CCGGCACGACCGTTTC-1	Tumor
CCGGCGCATATTGGAT-1	Invasive
CCGGCGTGAGACTCTG-1	Invasive
CCGGGACCCGCAGAGA-1	Invasive
CCGGGCGGTCTCGTCA-1	Invasive
CCGGGCTAAGAATTTC-1	Invasive
CCGGGCTGCTCCATAC-1	Surrounding tumor
CCGGGTTCGAGGTTAC-1	Invasive
CCGGTAATGGCTAGTC-1	Tumor
CCGTAAGTTGGTCCCA-1	Invasive
CCGTACCCAAGCGCCA-1	Invasive
CCGTAGGAAATCCCTG-1	Invasive
CCGTAGGGTTGTTTAC-1	Invasive
CCGTATCTCGTCGTAG-1	Surrounding tumor
CCGTATTAGCGCAGTT-1	Healthy
CCGTCAACCTCTGGCG-1	Invasive
CCGTGAGGCATTCATG-1	Tumor
CCGTGCCCATGACGGC-1	Invasive
CCGTGGAACGATCCAA-1	Healthy
CCGTGTTAAATTCCAT-1	Invasive
CCGTTACGTTAGAACA-1	Surrounding tumor
CCGTTCCGAATCTCGG-1	Surrounding tumor
CCTAAACAGGGTCCGT-1	Tumor
CCTAAAGGCTGACGCT-1	Surrounding tumor
CCTAAATTAACGGTTC-1	Invasive
CCTAAATTGTATCCTA-1	Surrounding tumor
CCTAACCCAAACAAGT-1	Surrounding tumor
CCTAACTAAGGCTCTA-1	Healthy
CCTACAAGTCCGGAAT-1	Healthy
CCTACATTCACAGACG-1	Surrounding tumor
CCTACGGCTCAGTCGA-1	Invasive
CCTACTGCTTACACTT-1	Invasive
CCTAGGCGTAGCGATC-1	Invasive
CCTAGGTAAAGGTAGC-1	Invasive
CCTAGTTAGTCGCATG-1	Surrounding tumor
CCTATAATGAGTGCCC-1	Tumor
CCTATATCGTGTCACG-1	Invasive
CCTATATTTGTCCTGG-1	Invasive
CCTATCTATATCGGAA-1	Surrounding tumor
CCTATGAAGTGGTGCC-1	Tumor
CCTATGGCTCCTAGTG-1	Invasive
CCTATGGGTTACCGTC-1	Invasive
CCTATGGTCAAAGCTG-1	Invasive
CCTATGTCCACTCCAC-1	Invasive
CCTCACCAATCTTGAC-1	Invasive
CCTCACCTGAGGGAGC-1	Surrounding tumor
CCTCACCTTAGCATCG-1	Healthy
CCTCATGCAGCTACGA-1	Invasive
CCTCCCGACAATCCCT-1	Tumor
CCTCCGACAATTCAAG-1	Invasive
CCTCCTAGCTAGAGTC-1	Invasive
CCTCCTGTTGTGTCGT-1	Invasive
CCTCGAAGTGGACGGG-1	Surrounding tumor
CCTCGACCCACTGCCT-1	Tumor
CCTCGCCAGCAAATTA-1	Surrounding tumor
CCTCGCGCGATATAGG-1	Healthy
CCTCGCGCTGTGCGAT-1	Tumor
CCTCGGACCGGGATAG-1	Invasive
CCTCGGTTTCCTTGCC-1	Invasive
CCTCGTTACGCCTGTT-1	Healthy
CCTCTAATCTGCCAAG-1	Invasive
CCTCTACAAGGATTGG-1	Invasive
CCTCTATCGATTAGCA-1	Surrounding tumor
CCTCTCTCCCATCTAG-1	Invasive
CCTCTGGCCTAGACGG-1	Surrounding tumor
CCTCTGTACTATTCTA-1	Healthy
CCTGAATATTTACATA-1	Invasive
CCTGACCACCGATGGT-1	Invasive
CCTGACGCAACCTTTA-1	Surrounding tumor
CCTGAGAATAAATGCA-1	Invasive
CCTGCGATAGAACTGT-1	Invasive
CCTGCTATTTGAGAAG-1	Invasive
CCTGGAAACGTTCTGC-1	Tumor
CCTGGCTAGACCCGCC-1	Surrounding tumor
CCTGGTCGAATGTGGG-1	Tumor
CCTGTAAGACATGATA-1	Invasive
CCTGTACTCACGCCCA-1	Invasive
CCTGTCACCCGGGCTC-1	Invasive
CCTGTCCCTCACGTTA-1	Tumor
CCTGTCGCCCGTAAAT-1	Invasive
CCTGTCGTGTATGAAG-1	Invasive
CCTGTTCAACCTCGGG-1	Invasive
CCTGTTTGAAGACACG-1	Invasive
CCTTAAGTACGCAATT-1	Surrounding tumor
CCTTCAGTTAAAGTGA-1	Invasive
CCTTCCGCAACGCTGC-1	Invasive
CCTTCGTATAGAATCC-1	Invasive
CCTTCTCAGCGTTCCT-1	Surrounding tumor
CCTTCTTGATCCAGTG-1	Invasive
CCTTGACCACTTTATT-1	Tumor
CCTTGTGAACGTGGTT-1	Invasive
CCTTTCAATGAAGAAA-1	Healthy
CGAAACATAGATGGCA-1	Tumor
CGAAACGCAATTCATG-1	Invasive
CGAACAGTATGGGCGT-1	Surrounding tumor
CGAACATAGTCAGAAA-1	Healthy
CGAACCCGCATGCGTC-1	Invasive
CGAACCTCTTTCCTAG-1	Invasive
CGAACGCCCAGTGCCG-1	Surrounding tumor
CGAACGGCCGGACAAC-1	Invasive
CGAAGATCAGTTTCAT-1	Invasive
CGAAGCTATAAATTCA-1	Healthy
CGAAGGGTTTCAGATT-1	Invasive
CGAAGTTGCTCTGTGT-1	Invasive
CGAATCTGCTCGACGC-1	Invasive
CGAATGAAGTCATTGC-1	Invasive
CGAATGACGCATAATG-1	Tumor
CGACAATTTGATCTAA-1	Surrounding tumor
CGACACCGCTTAAGGA-1	Healthy
CGACACGCTCCGACAG-1	Surrounding tumor
CGACAGTTCGCGTTAT-1	Invasive
CGACATGCGATCTTCT-1	Tumor
CGACCCTTAACGCCGG-1	Invasive
CGACGCATCCGTACCT-1	Invasive
CGACTCAGGATGTTAT-1	Healthy
CGACTCGGTACACGGT-1	Healthy
CGACTTTGTATAGCCT-1	Tumor
CGAGACCCTAGAGTGT-1	Invasive
CGAGACTACTGCTGCT-1	Invasive
CGAGAGATGTGAACCT-1	Invasive
CGAGAGCTTTCACTAC-1	Invasive
CGAGAGGGTAGCCGCG-1	Tumor
CGAGATTTCGCTCGGG-1	Surrounding tumor
CGAGCACTTCAAGTTT-1	Surrounding tumor
CGAGCGTTGATCAGCC-1	Invasive
CGAGCTGGGCTTTAGG-1	Surrounding tumor
CGAGGAGCTTCCATAT-1	Healthy
CGAGGATCGGGAACGA-1	Surrounding tumor
CGAGGCCAGGCATTGG-1	Invasive
CGAGGCTAAATATGGC-1	Invasive
CGAGGGACTGCGGTCG-1	Invasive
CGAGGGTATCCAGGTG-1	Tumor
CGAGTACTAAAGAGGA-1	Invasive
CGAGTGAAGGTACCAG-1	Invasive
CGAGTGCTATAGTTCG-1	Invasive
CGAGTTCTGTCCCACC-1	Surrounding tumor
CGAGTTTATCGGACTG-1	Invasive
CGATAATACTCAGGTT-1	Surrounding tumor
CGATACCTCGCGGACA-1	Invasive
CGATAGCGATACAGTG-1	Invasive
CGATAGTCGTACTGCA-1	Invasive
CGATATTAGCCGCAGG-1	Invasive
CGATCATTAGAGGCAC-1	Healthy
CGATCCACCATTGTTG-1	Invasive
CGATCCGACCCAGTGC-1	Invasive
CGATCCTCGCAACATA-1	Invasive
CGATCGAGAAGCACCA-1	Invasive
CGATCTGTTGGAGGAC-1	Surrounding tumor
CGATGGACCCTACGCC-1	Healthy
CGATGTTGTTATCTAC-1	Invasive
CGATTAAATATCTCCT-1	Tumor
CGATTCGCCTGGCTGC-1	Tumor
CGCAAACACGAGTTAC-1	Invasive
CGCAATTACTTTCGGT-1	Invasive
CGCAATTAGGGTAATA-1	Invasive
CGCAATTCTACAATAA-1	Surrounding tumor
CGCACATGTCCACTAC-1	Invasive
CGCACGTCTGTTTATG-1	Invasive
CGCACGTGCGCTATCA-1	Tumor
CGCAGAAACATTTGCG-1	Surrounding tumor
CGCAGATCTTCACCCG-1	Healthy
CGCAGGCGATCCAAAC-1	Surrounding tumor
CGCAGTTCTATCTTTC-1	Invasive
CGCATCATGGCTTCAG-1	Surrounding tumor
CGCATCCATCAGCCAG-1	Surrounding tumor
CGCATGCCGAATGCGT-1	Invasive
CGCATGGTGCGATGCT-1	Invasive
CGCATTAGCTAATAGG-1	Surrounding tumor
CGCCAAGAAGCCGAGT-1	Surrounding tumor
CGCCACCCGCATTAAC-1	Invasive
CGCCATCCGATTATGA-1	Surrounding tumor
CGCCCAGCACGCCTAG-1	Surrounding tumor
CGCCCAGCGTTTCACG-1	Invasive
CGCCCGCTTCCGTACA-1	Surrounding tumor
CGCCCTAATTGTTCAA-1	Invasive
CGCCCTTGAAGGCTGA-1	Surrounding tumor
CGCCGCCCATGCCTGT-1	Invasive
CGCCGCGTTCTGAACG-1	Invasive
CGCCGTTCAGCATAGT-1	Surrounding tumor
CGCCTCCCTCCTCTAT-1	Healthy
CGCCTGGCCTACGTAA-1	Invasive
CGCCTTTAGCATGCTC-1	Surrounding tumor
CGCGAAGTGGCATACT-1	Invasive
CGCGACCGCGACAGAT-1	Tumor
CGCGAGAGGGACTTGT-1	Healthy
CGCGAGTCTGCCGGGT-1	Invasive
CGCGCAAATGTCCAGA-1	Invasive
CGCGCAAGGAACTACA-1	Invasive
CGCGCCCGACTTAATA-1	Surrounding tumor
CGCGGCAGTATTACGG-1	Invasive
CGCGGCTCAACTTGAA-1	Tumor
CGCGGGAATTAGGCAG-1	Invasive
CGCGGGAATTCCTTTC-1	Invasive
CGCGGTAAGTCTAGCT-1	Surrounding tumor
CGCGGTACGGTATACA-1	Surrounding tumor
CGCGGTCACAAACCAA-1	Healthy
CGCGTACATTCTGGAA-1	Healthy
CGCGTCATATTAAACC-1	Tumor
CGCGTTCATGAAATAC-1	Invasive
CGCTACGGGACATTTA-1	Invasive
CGCTAGAGACCGCTGC-1	Tumor
CGCTATACCGCCCACT-1	Invasive
CGCTATTCAATGTATG-1	Invasive
CGCTATTCTTAGGCTC-1	Invasive
CGCTCGACATAATGAT-1	Invasive
CGCTCTCCGTAGATTA-1	Invasive
CGCTGGTGACTACCCT-1	Surrounding tumor
CGCTGTGACGCCGCAC-1	Invasive
CGCTGTGTGGATGTTG-1	Invasive
CGCTTAGTATTGATAC-1	Invasive
CGCTTATTCCCGGTCG-1	Invasive
CGCTTCCACTGAAATC-1	Invasive
CGCTTCGGTCTAAGAC-1	Invasive
CGCTTGGACGGATAGA-1	Surrounding tumor
CGCTTTCATACCGGTG-1	Invasive
CGCTTTCCGCCAAGGT-1	Surrounding tumor
CGCTTTCTTGCATTCG-1	Invasive
CGGAAATTTCACATCC-1	Surrounding tumor
CGGAACGTAAACATAG-1	Invasive
CGGACCTTTACGTCCC-1	Invasive
CGGAGCAATTTAATCG-1	Surrounding tumor
CGGAGCATGGCGATCC-1	Invasive
CGGAGCTTATAACACC-1	Surrounding tumor
CGGAGTTTGAGAGACA-1	Invasive
CGGATAAGCGGACATG-1	Invasive
CGGATCCTCAAGGACT-1	Tumor
CGGATGAATGCTGTGA-1	Invasive
CGGCAAACATCGTGCG-1	Healthy
CGGCAATAAGATCGCC-1	Surrounding tumor
CGGCACCGTTAGCGCC-1	Surrounding tumor
CGGCACTCAAGAAAGT-1	Invasive
CGGCAGGGTCGGGTTG-1	Healthy
CGGCCACGCACAAAGT-1	Invasive
CGGCCAGAGCGACCAT-1	Invasive
CGGCCCAACCTGTAGT-1	Surrounding tumor
CGGCCCAGGTATATCC-1	Tumor
CGGCGCCATCAATCCC-1	Invasive
CGGCTCTAAAGCTGCA-1	Surrounding tumor
CGGCTCTTCGTCGAAC-1	Surrounding tumor
CGGCTGCAAGATTAAG-1	Tumor
CGGCTTTGTATGATAA-1	Surrounding tumor
CGGGAACGCCCTGCAT-1	Invasive
CGGGAAGTACCGTGGC-1	Invasive
CGGGAATATAGTATAC-1	Surrounding tumor
CGGGAATTTATGTAAA-1	Healthy
CGGGAGCTTCAGTGTA-1	Surrounding tumor
CGGGAGTATACCGCCG-1	Invasive
CGGGATCAATGTAAGA-1	Invasive
CGGGCAGCTAAACCGC-1	Invasive
CGGGCCATAGCCGCAC-1	Invasive
CGGGCCTTCTTTGTAA-1	Invasive
CGGGCGATGGATCACG-1	Invasive
CGGGTGTACCCATTTA-1	Invasive
CGGGTTCGGCACGTAT-1	Healthy
CGGGTTTGTTAGGGCT-1	Surrounding tumor
CGGTAGAGGTGCAGGT-1	Healthy
CGGTATAGGTATTAGC-1	Healthy
CGGTATGGGCACTCTG-1	Invasive
CGGTCAAGTGGGAACC-1	Invasive
CGGTCCATGAGACTCC-1	Healthy
CGGTCCGTCGCAAGCC-1	Invasive
CGGTCTATCAACCCGT-1	Surrounding tumor
CGGTGAAGACTAAAGT-1	Invasive
CGGTGCAGATAGAACG-1	Invasive
CGGTGCGCGTTGGTCC-1	Surrounding tumor
CGGTGGGCTCCAGCCT-1	Healthy
CGGTGTACTTGATCCC-1	Invasive
CGGTTATCCAACAGTG-1	Healthy
CGGTTCAAGTAGGTGT-1	Healthy
CGGTTCCGGCTTCTTG-1	Invasive
CGGTTGACCTGGCATA-1	Invasive
CGGTTGAGTATCCTTC-1	Invasive
CGGTTGGGCAGGGTCC-1	Surrounding tumor
CGGTTGGGTTCAAGTT-1	Healthy
CGGTTTATGAAGGAAC-1	Healthy
CGTAAACGCTTGAGTG-1	Invasive
CGTAAAGCAAGAAATC-1	Invasive
CGTAACTTCGACACTT-1	Invasive
CGTACCGAAAGTCTAG-1	Invasive
CGTACCTGATAGGCCT-1	Invasive
CGTAGAGAGTAATTAT-1	Invasive
CGTAGCGAATTGTCAG-1	Surrounding tumor
CGTAGCGCCGACGTTG-1	Surrounding tumor
CGTATTAAGAGATCTA-1	Invasive
CGTCACGTCCATTGGT-1	Invasive
CGTCAGTGCGCACAAG-1	Invasive
CGTCAGTTTATCGTCT-1	Tumor
CGTCATACCATATCCA-1	Invasive
CGTCCTCATCGCGTGC-1	Invasive
CGTCGCATGTGAGCCA-1	Invasive
CGTCGCGGCGGGATTT-1	Invasive
CGTCGCTTGGTTATAC-1	Invasive
CGTCGGATAGTGTTGA-1	Surrounding tumor
CGTCGGGTCTAAGCGC-1	Surrounding tumor
CGTCGTCCTTCGCGAA-1	Tumor
CGTCTGGAAGGGCCCG-1	Invasive
CGTGAAGTTAATTCAC-1	Invasive
CGTGACATTGGGTCGT-1	Surrounding tumor
CGTGACCAGTCCTCTG-1	Tumor
CGTGCACACCACTGTA-1	Invasive
CGTGCAGACTGGGACA-1	Invasive
CGTGCATTGTCGACGC-1	Invasive
CGTGCCCGACATTTGT-1	Tumor
CGTGCTGGCCTAGTCG-1	Invasive
CGTGCTTCTACCTAAA-1	Invasive
CGTGGAAGCCTCGTAC-1	Surrounding tumor
CGTGGCCGAATATCTA-1	Surrounding tumor
CGTGGTACCCAAAGGC-1	Invasive
CGTGTATGGGAGCTGA-1	Invasive
CGTGTCCCATTCGCGA-1	Invasive
CGTGTCTCGTTACGAC-1	Invasive
CGTGTGTTAAACCCTG-1	Tumor
CGTTAAACTAGTTAGG-1	Surrounding tumor
CGTTAAATACGACCAG-1	Invasive
CGTTAATGTCCCGACG-1	Invasive
CGTTAGCTCACAACTG-1	Surrounding tumor
CGTTCAAGGAAACGGA-1	Invasive
CGTTCAGACCCGCGAA-1	Tumor
CGTTCATGGTGCGCGT-1	Invasive
CGTTCTTCGCACACCT-1	Healthy
CGTTGAATACCGCGCT-1	Tumor
CGTTGAGTAATTGCGT-1	Healthy
CGTTGCCCGCGTGGGA-1	Invasive
CGTTGTAAGATTGATT-1	Surrounding tumor
CGTTGTCGGCAATTGA-1	Tumor
CGTTGTTTCAATTCCC-1	Invasive
CGTTTAAGCGGAGCAC-1	Invasive
CGTTTACAAGGCAGCT-1	Healthy
CGTTTCACTTCGGGCG-1	Healthy
CGTTTCGCTCATTACA-1	Invasive
CGTTTCGGTTATATGC-1	Invasive
CTAAAGAATGCCTACT-1	Invasive
CTAAAGGGAAATAGGA-1	Invasive
CTAAAGTCCGAAGCTA-1	Invasive
CTAAATCCGGTGTACA-1	Invasive
CTAAATCCTATTCCGG-1	Surrounding tumor
CTAACCGCGCGCCCGT-1	Invasive
CTAACGAAACTTGCTG-1	Healthy
CTAACTGATAATCGCC-1	Surrounding tumor
CTAACTGGTCCGGTTC-1	Surrounding tumor
CTAAGTACAGGGCTAC-1	Healthy
CTAATTATGAAGCGTA-1	Healthy
CTAATTCGCACGCGCT-1	Invasive
CTAATTCTCAGATATT-1	Surrounding tumor
CTAATTTCAACAACAC-1	Invasive
CTACAAGAAATAACCC-1	Invasive
CTACACTCGCAGATGG-1	Surrounding tumor
CTACATATCGCGGGAC-1	Invasive
CTACCCTAAGGTCATA-1	Healthy
CTACGAACTAGGTCGA-1	Tumor
CTACGACTAGCTATAA-1	Invasive
CTACGATCCTATCCTA-1	Invasive
CTACGCACGGAGTACC-1	Invasive
CTACGCCATTTCCGAT-1	Surrounding tumor
CTACGTGTTGCCACCA-1	Invasive
CTACTATCATAGGTTT-1	Surrounding tumor
CTACTATCTTTCAGAG-1	Healthy
CTACTCAAGGTATAGT-1	Invasive
CTACTCTAGGCCCGGC-1	Invasive
CTACTGCCACCTGACC-1	Invasive
CTAGACATATATGTAG-1	Healthy
CTAGACTGCATTTCGT-1	Healthy
CTAGATAAACTCCTCG-1	Invasive
CTAGATGTGAGTGTAA-1	Tumor
CTAGATTTACGACGGC-1	Healthy
CTAGCATAGTATAATG-1	Invasive
CTAGCCACAGGCGAGC-1	Tumor
CTAGCCGATGTTATGA-1	Healthy
CTAGGCGCCCTATCAG-1	Invasive
CTAGGCGGCAGAGAAT-1	Surrounding tumor
CTAGGGATAGGGACAA-1	Invasive
CTAGGTCTGAAGGAAT-1	Tumor
CTAGGTTCGGACGTGA-1	Tumor
CTAGTAGAAAGGGATT-1	Invasive
CTAGTATTCGGAATTA-1	Surrounding tumor
CTAGTCACGTCTTAAG-1	Invasive
CTAGTGAAGGACAGGA-1	Invasive
CTAGTTACAACCCGGT-1	Tumor
CTAGTTGGGCCCGGTA-1	Invasive
CTATAAGAGCCAATCG-1	Healthy
CTATAGGCGTTGATGT-1	Invasive
CTATATCCAGCCTGGC-1	Invasive
CTATCACAACGCTGGA-1	Invasive
CTATCGACGAAATACA-1	Invasive
CTATCGCGTAGAGAAC-1	Surrounding tumor
CTATCGGGTCTCAACA-1	Invasive
CTATGCCCGAATGCAA-1	Tumor
CTATGGGAAGCGGAAT-1	Surrounding tumor
CTATGTCACTAGCCCA-1	Surrounding tumor
CTATGTCTATTGAAAC-1	Invasive
CTATGTGAGTCACGGC-1	Surrounding tumor
CTATTCATGTGTCCCA-1	Healthy
CTATTGTGTTTGGTCA-1	Healthy
CTATTTGCTTGGAGGA-1	Surrounding tumor
CTATTTGGTTACGGAT-1	Invasive
CTCAAACCACTGCCCG-1	Invasive
CTCAACTAACCCGGAT-1	Invasive
CTCAAGACATTAGCGC-1	Healthy
CTCACACGCAAGCCTA-1	Healthy
CTCACATTTACTAAAT-1	Tumor
CTCACCGATCCAAACT-1	Healthy
CTCACTGTGATACTTA-1	Tumor
CTCACTTGGCTGGTAA-1	Invasive
CTCAGAGCTAATGTCG-1	Invasive
CTCAGGACTCACCTGT-1	Invasive
CTCAGTCACGACAAAT-1	Healthy
CTCATAAATGTGTATA-1	Invasive
CTCATGGCTCACAATC-1	Surrounding tumor
CTCATGGTAATTTGCG-1	Surrounding tumor
CTCATTGCTCTAACAA-1	Tumor
CTCATTTGATGGGCGG-1	Surrounding tumor
CTCCCAATGAGTCGCG-1	Surrounding tumor
CTCCCTCCTTTCGATC-1	Invasive
CTCCGCCCACATGAGG-1	Invasive
CTCCGGCCTAATATGC-1	Invasive
CTCCGGCTTGTAGACA-1	Invasive
CTCCTAAGTTATGTCT-1	Invasive
CTCCTCCAGCTCACAC-1	Invasive
CTCCTGTTCAAGGCAG-1	Surrounding tumor
CTCCTTTACGCAAGTC-1	Healthy
CTCGAATGGAACGTAT-1	Healthy
CTCGAGATCCAAAGCA-1	Invasive
CTCGAGGTCGAACAGT-1	Invasive
CTCGATATTTGCGAGC-1	Healthy
CTCGCACCTATATAGT-1	Invasive
CTCGCATTGCATAGCC-1	Invasive
CTCGCCGAATGTAGGG-1	Tumor
CTCGCTAGGTAAGCGA-1	Invasive
CTCGGGATAACACCTA-1	Surrounding tumor
CTCGGGCATCGTCGGG-1	Tumor
CTCGGGTTCTCTGGCC-1	Invasive
CTCGGTACCACTGCTC-1	Invasive
CTCGGTCCGTAGCCTG-1	Invasive
CTCGGTTGTCGGCCCT-1	Invasive
CTCGTCGAGGGCTCAT-1	Invasive
CTCGTCTGTGCCTTCG-1	Invasive
CTCGTTACGGCTACCA-1	Invasive
CTCGTTTCTAATGTTT-1	Healthy
CTCTAATGCATTGATC-1	Healthy
CTCTACACTGGCGATT-1	Surrounding tumor
CTCTACATCCTGCGTG-1	Invasive
CTCTAGCCCTCGGAAA-1	Invasive
CTCTATTTGGCTGCAG-1	Healthy
CTCTCACAATCGATGA-1	Invasive
CTCTCGATGTGCGCCT-1	Tumor
CTCTCTAACTGCCTAG-1	Invasive
CTCTGCAGGCATTCTT-1	Invasive
CTCTGCGAAGCAAGCA-1	Invasive
CTCTGGACGCCTGGTG-1	Invasive
CTCTGTTTGAGGATTC-1	Surrounding tumor
CTCTTCTATTGACTGG-1	Tumor
CTCTTCTGGAAGTTAG-1	Invasive
CTCTTGTCCCGCTTGG-1	Healthy
CTGAAACGGCCCTCAG-1	Surrounding tumor
CTGAAAGAGATCCGAC-1	Invasive
CTGAATCCGAGACCTC-1	Invasive
CTGAATTTATTGCCAG-1	Healthy
CTGACATAGAAATAGA-1	Surrounding tumor
CTGACTGCGCAGCTCG-1	Surrounding tumor
CTGAGAAAGTTCGGCG-1	Surrounding tumor
CTGAGCAAGTAACAAG-1	Invasive
CTGCAAATGGGCTCCA-1	Tumor
CTGCAAGCACGTTCCG-1	Surrounding tumor
CTGCACAACTACATAT-1	Healthy
CTGCACCTAGTCCACA-1	Surrounding tumor
CTGCACCTGGAACCGC-1	Invasive
CTGCACTCCAGTACAG-1	Tumor
CTGCAGAGAATCAGAG-1	Invasive
CTGCCAAGGTTGGAAG-1	Surrounding tumor
CTGCCATGCATCACAT-1	Invasive
CTGCCTAGCCACCAAG-1	Tumor
CTGCCTCATATGCAAC-1	Surrounding tumor
CTGCCTTTAATACCTT-1	Invasive
CTGCCTTTCTAGTAAA-1	Invasive
CTGCGACCTCGCCGAA-1	Invasive
CTGCGATTTCGAGATT-1	Invasive
CTGCGGGTGAAATGTT-1	Invasive
CTGCGGTAGTCACGTG-1	Healthy
CTGCGTTACGATATAA-1	Surrounding tumor
CTGCTCTGACGGCAAA-1	Invasive
CTGCTGAGGCCACGAA-1	Surrounding tumor
CTGCTGTCTAACGAGC-1	Surrounding tumor
CTGCTTGGCGATAGCT-1	Tumor
CTGCTTTATGTCCGCG-1	Healthy
CTGGAAATGGATGCTT-1	Invasive
CTGGAAGACACGGTGG-1	Surrounding tumor
CTGGACGCAGTCCGGC-1	Invasive
CTGGCATCCGAATGAG-1	Surrounding tumor
CTGGCGACATAAGTCC-1	Surrounding tumor
CTGGCGATTTACATGT-1	Invasive
CTGGCGCACAGGTCTG-1	Invasive
CTGGCGGGAATAAGTA-1	Invasive
CTGGCTCCTGCGGGAT-1	Invasive
CTGGCTGATTCATCCT-1	Surrounding tumor
CTGGCTGCTAACGTAA-1	Invasive
CTGGGATACGCTACCC-1	Tumor
CTGGGATCGCCCAGAT-1	Tumor
CTGGGCCTGCTATATC-1	Invasive
CTGGGCTACTGGAGAG-1	Invasive
CTGGGCTATCCTTTGG-1	Healthy
CTGGGTTGAGTTAAAG-1	Invasive
CTGGTAAAGACTTACA-1	Invasive
CTGGTAAAGTGTGGGC-1	Tumor
CTGGTAACACATAGAA-1	Invasive
CTGGTAACGAGCTCTT-1	Healthy
CTGGTCATTCCAATCC-1	Surrounding tumor
CTGGTCCTAACTTGGC-1	Tumor
CTGGTGAATGGGCCTA-1	Invasive
CTGGTTCAACGCATCA-1	Invasive
CTGGTTTCGAGCAAGA-1	Surrounding tumor
CTGTACTTCTTAGCAT-1	Invasive
CTGTAGTGAGGATCGA-1	Invasive
CTGTATGGTGTAGAAA-1	Invasive
CTGTCAAATGGCTCGG-1	Surrounding tumor
CTGTCACGCCAGGCGC-1	Healthy
CTGTGCAGGGTAGGTC-1	Invasive
CTGTGGTCGGGAGATA-1	Invasive
CTGTTACCCAATCTAG-1	Healthy
CTGTTCACTGCCTGTG-1	Invasive
CTGTTCATCTCACGGG-1	Invasive
CTGTTGTTCAGTCGTA-1	Invasive
CTTAACTTACAGTATA-1	Invasive
CTTAACTTCGAAGTAC-1	Surrounding tumor
CTTACACGGTATTCCA-1	Invasive
CTTACACTGGGAAATA-1	Invasive
CTTACATAGATTTCTT-1	Invasive
CTTAGATGTTTCATCC-1	Invasive
CTTAGCCTTCCACATG-1	Surrounding tumor
CTTAGGTATAGACCAG-1	Invasive
CTTAGTAGGCCTACAG-1	Surrounding tumor
CTTAGTGTAGTAGCAT-1	Surrounding tumor
CTTAGTTGAGGAATCG-1	Invasive
CTTATGCGCTCAGGGC-1	Surrounding tumor
CTTATGTTGACTACCA-1	Invasive
CTTCAACTCCACTTGG-1	Tumor
CTTCACGCCCTGGTAC-1	Invasive
CTTCAGTGGTCGCCTA-1	Surrounding tumor
CTTCAGTTGGACAACG-1	Invasive
CTTCATAGCTCAAGAA-1	Invasive
CTTCATTGTCAGTGGA-1	Invasive
CTTCGATTGCGCAAGC-1	Invasive
CTTCGGCCAATTGTTT-1	Surrounding tumor
CTTCGTAGATAGGTGA-1	Invasive
CTTCTATGTTGAAGTA-1	Surrounding tumor
CTTCTGGGCGTACCTA-1	Invasive
CTTCTTACGTCGTATA-1	Invasive
CTTGACCCGAAAGATA-1	Surrounding tumor
CTTGAGGTTATCCCGA-1	Invasive
CTTGAGTTAGGGTAAT-1	Invasive
CTTGATGACCATCCAG-1	Invasive
CTTGCAACCGCCTCCT-1	Surrounding tumor
CTTGCCCACCCACGCA-1	Invasive
CTTGCCCAGGCTCTAC-1	Invasive
CTTGGCCAAGCTGGGA-1	Tumor
CTTGTACTTGTTGACT-1	Invasive
CTTGTCAACATTCGAG-1	Healthy
CTTGTGAGTCTTTGAC-1	Invasive
CTTGTGCTCACCGATT-1	Healthy
CTTGTTGCTGAGTCAA-1	Invasive
CTTGTTTATGTAGCCA-1	Invasive
CTTTAACTTTCAAAGG-1	Invasive
CTTTAATATTGGTCGA-1	Healthy
CTTTACCGAATAGTAG-1	Surrounding tumor
CTTTAGTGCTATTATT-1	Healthy
CTTTCTGTGCGGGCTT-1	Tumor
CTTTGCATCGCTCTTG-1	Invasive
CTTTGGCAGACAGAGT-1	Healthy
CTTTGGCGCTTTATAC-1	Surrounding tumor
CTTTGGCTTTAGTAAA-1	Invasive
CTTTGGGATTGTTGCA-1	Invasive
GAAACAGATGACCACC-1	Invasive
GAAACAGCCATGCAGT-1	Invasive
GAAACATAGGAAACAG-1	Invasive
GAAACCATGGTGCGCT-1	Surrounding tumor
GAAACCGAATTACCTT-1	Invasive
GAAACCTATACAAATG-1	Invasive
GAAACTCGTGCGATGC-1	Invasive
GAAACTCTAATGAAGG-1	Surrounding tumor
GAAAGAACAGCGTTAT-1	Tumor
GAAAGCAGTGCACTTT-1	Healthy
GAAAGCCCTTTGGACC-1	Invasive
GAAAGTGACTAACTGC-1	Surrounding tumor
GAAATACCTGCTGGCT-1	Surrounding tumor
GAAATACTAAACGTTT-1	Invasive
GAAATATCACCATCAG-1	Invasive
GAAATATGCTTGAATG-1	Healthy
GAAATCGCGCGCAACT-1	Invasive
GAAATGGCGGTGTTAG-1	Invasive
GAAATGGGATGTAAAC-1	Invasive
GAAATTAGCACGGATA-1	Healthy
GAAATTCACATCGCTG-1	Invasive
GAAATTGTCTCTATAA-1	Invasive
GAACAACTGGGATGAA-1	Invasive
GAACACACATCAACCA-1	Invasive
GAACAGATTACTAAAT-1	Tumor
GAACATTAGTATGTTA-1	Healthy
GAACCATCTGGGAGAC-1	Tumor
GAACCCTCTGTGTTCT-1	Tumor
GAACCTTTAACGATCC-1	Invasive
GAACGACCGAATGATA-1	Invasive
GAACGATAAGTTAAAG-1	Healthy
GAACGCGGGTCACACG-1	Surrounding tumor
GAACGGTGTAAAGCAG-1	Healthy
GAACGTCTCATGGTCG-1	Invasive
GAACTGTGGAGAGACA-1	Invasive
GAACTTAGCGCCCGGT-1	Surrounding tumor
GAAGAAACGATATTGT-1	Invasive
GAAGAACGGTGCAGGT-1	Invasive
GAAGACTTCAATGCCG-1	Tumor
GAAGCCACTGATTATG-1	Invasive
GAAGCCTGCACATTCC-1	Tumor
GAAGCGTGAGGAATTT-1	Invasive
GAAGCTCGGACCCGTC-1	Surrounding tumor
GAAGCTTGCTGACCGC-1	Invasive
GAAGGAGTCGAGTGCG-1	Surrounding tumor
GAAGGCTACCATTGTT-1	Healthy
GAAGGGCATAACCATG-1	Surrounding tumor
GAAGGGTCATTAAGAC-1	Invasive
GAAGTCTCCCTAGCGA-1	Invasive
GAAGTGATTTATCGTG-1	Invasive
GAAGTGCTGGATAGCT-1	Invasive
GAAGTTTCCACTCAAT-1	Invasive
GAATAGACGCGACCCA-1	Invasive
GAATAGCATTTAGGGT-1	Surrounding tumor
GAATAGCCCTGCGGTC-1	Healthy
GAATAGTGCTCGATTA-1	Invasive
GAATATTCGGAGTCCC-1	Surrounding tumor
GAATCGACATGGTCAC-1	Invasive
GAATCGCCGGACACGG-1	Invasive
GAATCTGAACATTCTC-1	Invasive
GAATGAAGGTCTTCAG-1	Healthy
GAATGCCGAAATGACC-1	Invasive
GAATGCGAATCGGTTC-1	Tumor
GAATGTATGGCAGGTC-1	Surrounding tumor
GAATGTTGGGTAATCT-1	Invasive
GAATTATAGTGAAAGG-1	Invasive
GAATTCACCCGGGTGT-1	Invasive
GAATTTCTCGCTGCAG-1	Invasive
GACAAACATATGCAGG-1	Tumor
GACAACGACCATTGAA-1	Invasive
GACAACGCAGCTTACG-1	Invasive
GACAAGAGATGAGATT-1	Surrounding tumor
GACACAAGGGAAGAAA-1	Invasive
GACACAGCCGGGACTG-1	Invasive
GACACGAGTTAGAGGA-1	Invasive
GACACTGAGTTCAGTG-1	Invasive
GACACTGGAACCCGAT-1	Surrounding tumor
GACACTTCCAATTACC-1	Invasive
GACAGGCACACACTAT-1	Invasive
GACAGGTAATCCGTGT-1	Invasive
GACATCCGTCGAACTG-1	Invasive
GACATTTCGCCCAGCC-1	Invasive
GACCAAACGTTGACTG-1	Tumor
GACCACACTTCCCTTT-1	Invasive
GACCAGAGCCCTGTAG-1	Invasive
GACCAGGTCATTCATA-1	Tumor
GACCCAATTATGATAC-1	Invasive
GACCCGTCGCCGGCTA-1	Surrounding tumor
GACCGACGTGAAAGCA-1	Tumor
GACCGACTGAAGCGTC-1	Invasive
GACCGATTAAATATGT-1	Invasive
GACCGCGTCTGACGTG-1	Surrounding tumor
GACCGTCAGGTCGTGA-1	Surrounding tumor
GACCGTGCTGACGGTG-1	Invasive
GACCTTCCACGTCTAC-1	Invasive
GACGACGATCCGCGTT-1	Tumor
GACGAGGCTAATAAAC-1	Invasive
GACGATATCACTGGGT-1	Invasive
GACGCCTGTTGCAGGG-1	Invasive
GACGCTTGCTTCTAAA-1	Invasive
GACGGACCGCGTTCCT-1	Tumor
GACGGGCATCGAATTT-1	Invasive
GACGGGTTGGCCCGTA-1	Invasive
GACGGTCAATAGAAGC-1	Surrounding tumor
GACGTGAGACTCCATG-1	Invasive
GACGTGTAGGGATTAT-1	Invasive
GACGTTCGTAAATACA-1	Healthy
GACTAACACAGCACCT-1	Surrounding tumor
GACTAAGATCATGCAC-1	Invasive
GACTAAGTAGGCTCAC-1	Invasive
GACTACAAAGCGGTGG-1	Invasive
GACTACAATTGCTCGT-1	Tumor
GACTAGGCCGTTAGGT-1	Invasive
GACTCACCCACGTGAG-1	Tumor
GACTCCCAGAATAAGG-1	Surrounding tumor
GACTCCTTCCAATTGA-1	Invasive
GACTCGCGGGAATGAC-1	Healthy
GACTCGGTCGGCGGAT-1	Healthy
GACTCTAGAGTTCCAA-1	Invasive
GACTGATTGGTCACAA-1	Healthy
GACTGCAAATCGAGCT-1	Tumor
GACTGCGGCACGTGTA-1	Surrounding tumor
GACTGCTGGTGAGAAA-1	Invasive
GACTGGGCGCCGCAAC-1	Healthy
GACTTCAACGCATCAA-1	Surrounding tumor
GAGAACGGTTCTGACT-1	Invasive
GAGACCCTGCAACGCC-1	Healthy
GAGACTGATGGGTAGA-1	Invasive
GAGAGGCCTATGTGTA-1	Surrounding tumor
GAGAGGGCGCGAGGTT-1	Invasive
GAGAGGTGCATTCTGG-1	Invasive
GAGAGTCTCGGGAGAG-1	Invasive
GAGATCTGCTTGGCAT-1	Invasive
GAGATCTGTCACTCCG-1	Invasive
GAGATGACAATCCTTA-1	Healthy
GAGATGGCTTTAATCA-1	Invasive
GAGATGGGAGTCGACA-1	Tumor
GAGCACCTGTGTCCAG-1	Tumor
GAGCATCAACAACTTG-1	Invasive
GAGCATCATCCCTGGG-1	Invasive
GAGCCACGGTAGTAGG-1	Invasive
GAGCCAGCTACCTGTG-1	Invasive
GAGCCGAGCGTTTATT-1	Healthy
GAGCGAGGGAGTACCG-1	Invasive
GAGCGCAAATACTCCG-1	Surrounding tumor
GAGCGCGCACGAGTAG-1	Surrounding tumor
GAGCGCTGTTAGGTAA-1	Invasive
GAGCGGAATGCGGTGT-1	Invasive
GAGCTAAGGGCATATC-1	Invasive
GAGCTCAACATGAGCG-1	Invasive
GAGCTCTCGGACCTAA-1	Invasive
GAGCTGTCGTCTCGGA-1	Healthy
GAGGAATATCTCTTTG-1	Invasive
GAGGAATGGAGAGGTT-1	Surrounding tumor
GAGGATAAACAGTGCT-1	Tumor
GAGGCATTTGCAGCAG-1	Healthy
GAGGCCCGACTCCGCA-1	Invasive
GAGGCCTGTTGATACA-1	Invasive
GAGGCTATCAAAGTCG-1	Invasive
GAGGGAGTCAGATCGC-1	Invasive
GAGGGCATCGCGTATC-1	Invasive
GAGGGCCATAATATTA-1	Surrounding tumor
GAGGGCGCAGCTCTGC-1	Healthy
GAGGGTAGTAACAAAG-1	Invasive
GAGGTACATCCATCTT-1	Surrounding tumor
GAGGTACGCGTGTCCC-1	Invasive
GAGGTCCCAAAGATCT-1	Invasive
GAGTAAACCGGAAAGT-1	Surrounding tumor
GAGTAAGGCCACGGGA-1	Invasive
GAGTACGGGTATACAA-1	Invasive
GAGTAGATACTAGTTG-1	Tumor
GAGTATGCGCGTGCAT-1	Tumor
GAGTCCGCTTACCGGA-1	Invasive
GAGTGTCAACCAGAAA-1	Invasive
GAGTGTGCGGTACCCA-1	Invasive
GAGTTGATGGCAATTT-1	Invasive
GAGTTGTCACCAGTCT-1	Invasive
GATAAATCGGTGGATG-1	Invasive
GATAACTCGCACTGTG-1	Invasive
GATAAGGCAGATGCAA-1	Invasive
GATACGATGGGAGTCA-1	Invasive
GATAGAACCCGCTAGG-1	Invasive
GATAGATAGTACAGTC-1	Invasive
GATAGGTAACGTTGAC-1	Healthy
GATAGTGCGAGTAAGT-1	Invasive
GATATCTCATGCAATA-1	Invasive
GATATGAGACACTAAC-1	Surrounding tumor
GATATGCGGTAGCCAA-1	Surrounding tumor
GATATGGATTACGCGG-1	Surrounding tumor
GATATTGAGATTGGCG-1	Surrounding tumor
GATATTTCCTACATGG-1	Surrounding tumor
GATCAACATAAAGGGA-1	Invasive
GATCATTCCAAACATT-1	Invasive
GATCCCTTTATACTGC-1	Surrounding tumor
GATCCGGGAATTAACA-1	Invasive
GATCCTAAATCGGGAC-1	Healthy
GATCCTCGACACTGGC-1	Surrounding tumor
GATCCTCTTGCGCTTA-1	Surrounding tumor
GATCGACACTATCTGA-1	Invasive
GATCGCGGGCTCTCCA-1	Invasive
GATCGCTACCCGATTT-1	Surrounding tumor
GATCGCTATATCTCAG-1	Invasive
GATCGCTGTGGTGCGT-1	Invasive
GATCGGATAGAACCAT-1	Surrounding tumor
GATCGGCGATAAGTCG-1	Invasive
GATCGGTGGCCATAAC-1	Invasive
GATCGTGACTGATATC-1	Invasive
GATCTCGACGCTGTGG-1	Surrounding tumor
GATCTGCTATCTAAGG-1	Tumor
GATCTTGGAGGGCATA-1	Healthy
GATCTTTGCAGGGTAT-1	Invasive
GATCTTTGCTCAAAGA-1	Healthy
GATGACAAGTAGGGCA-1	Invasive
GATGACGATGATCGCG-1	Healthy
GATGAGGAACCTTCGG-1	Invasive
GATGCCAGCAGAAGGC-1	Surrounding tumor
GATGCCTTCTGCGGCA-1	Invasive
GATGCGTCCTGCATTC-1	Invasive
GATGCTACAAGCGCCT-1	Invasive
GATGCTACCTTCGATG-1	Invasive
GATGCTGTATTTCATC-1	Surrounding tumor
GATGGCGCACACATTA-1	Invasive
GATGGTGAAATAACCC-1	Healthy
GATGGTGCCCTAGGCA-1	Tumor
GATGTAACGAACCACC-1	Invasive
GATGTCCGGATCACAT-1	Invasive
GATGTCGGTCAACTGC-1	Tumor
GATGTGTTGTCACAAG-1	Tumor
GATGTTCAATCCACGA-1	Invasive
GATGTTTGTGCGAGAT-1	Invasive
GATTAACCGAAAGCCC-1	Invasive
GATTAATCCTGGCTCA-1	Invasive
GATTACTGAATTTGGG-1	Invasive
GATTCCCTTGTCGCAG-1	Invasive
GATTCCGCGTTTCCGT-1	Surrounding tumor
GATTCCTATACGGCGC-1	Surrounding tumor
GATTCGACGGTTCACG-1	Invasive
GATTCTGTTAATGAGT-1	Invasive
GATTGACACTCTGCTC-1	Tumor
GATTGCTCCAGTTGCA-1	Invasive
GATTGGGAAAGGTTGT-1	Invasive
GCAAACCCTACATTAT-1	Healthy
GCAAACCTTGGCCATA-1	Tumor
GCAAACGTCGCCAGGT-1	Surrounding tumor
GCAAAGGGCGTTAGCC-1	Invasive
GCAAATATTACGCTTT-1	Invasive
GCAACACACTAGAACT-1	Surrounding tumor
GCAACAGCAGTATGCG-1	Surrounding tumor
GCAACCACCAGACCGG-1	Healthy
GCAACCACGGCCGCGT-1	Invasive
GCAACGGCTAGTTATG-1	Tumor
GCAAGAATTCCTTGGC-1	Invasive
GCAAGATGTGTTCGCG-1	Healthy
GCAAGTGCACAGAGAA-1	Invasive
GCAAGTGTAAAGCATG-1	Invasive
GCAATTAGTCGCACCG-1	Surrounding tumor
GCACAAACCCTAGATG-1	Invasive
GCACAAACGAGGCGTG-1	Surrounding tumor
GCACAACCTCGGGCGT-1	Invasive
GCACAAGTGTCGGAAG-1	Tumor
GCACACACTGGTAGCC-1	Invasive
GCACACAGCTATTACC-1	Surrounding tumor
GCACAGCACGGGCCGA-1	Invasive
GCACCTAGGCGAGTCC-1	Invasive
GCACGCCGATTCCCGC-1	Invasive
GCACGTGGTTTACTTA-1	Invasive
GCACTAGTCGCGCTAT-1	Invasive
GCACTGCCTACCTTTA-1	Invasive
GCACTGTGCAAATGTA-1	Invasive
GCAGAAACGTAATCCA-1	Healthy
GCAGACCCAGCACGTA-1	Tumor
GCAGATCCATAAGACT-1	Surrounding tumor
GCAGATTAGGGATATC-1	Invasive
GCAGCACACAGCCCAG-1	Invasive
GCAGCCTATATCACAT-1	Tumor
GCAGCGGTGGGCATTA-1	Invasive
GCAGCTATGGACAGGT-1	Healthy
GCAGCTGTCAACGCAT-1	Invasive
GCAGGAACTTAGATCT-1	Invasive
GCAGGACTATAGAATA-1	Invasive
GCAGGTAGAGTATGGT-1	Healthy
GCAGTGTGGCTATAGG-1	Tumor
GCAGTTCGATCCGAGC-1	Surrounding tumor
GCATACGAGGTCTTTA-1	Surrounding tumor
GCATAGAGCACTCAGG-1	Invasive
GCATCCCTAACTTTGA-1	Invasive
GCATCGGCCGTGTAGG-1	Surrounding tumor
GCATGAGGGACGCGGC-1	Healthy
GCATGCTAATAACGAT-1	Invasive
GCATTCAAGGCAACGC-1	Surrounding tumor
GCATTCGAAATGAACA-1	Surrounding tumor
GCATTGTAATTCATAT-1	Surrounding tumor
GCATTTCCAAGGCTCC-1	Tumor
GCCAACCATTTCCGGA-1	Surrounding tumor
GCCAAGAATACTTCTG-1	Surrounding tumor
GCCAATAGGGCATCTC-1	Healthy
GCCACAATTTAAGGAC-1	Invasive
GCCACTCAGAGCGCGA-1	Invasive
GCCACTCCTTACGGTA-1	Surrounding tumor
GCCAGGAAAGAACACT-1	Invasive
GCCAGGAGTAACCGAT-1	Surrounding tumor
GCCAGGCGTTCGCATG-1	Surrounding tumor
GCCATATTGCACACAG-1	Surrounding tumor
GCCATCGATGCTGCAT-1	Tumor
GCCATTAGCCTCAAAC-1	Invasive
GCCCACCAAGGCTGTC-1	Invasive
GCCCAGATGCTGGAGA-1	Tumor
GCCCAGTTGGTATGCC-1	Invasive
GCCCGACTTCTTCCCG-1	Surrounding tumor
GCCCGAGAGTCTAAAT-1	Invasive
GCCCGATCTGTGGTCG-1	Surrounding tumor
GCCCGCGCGTAAACGG-1	Surrounding tumor
GCCCGCGCGTTTGACA-1	Invasive
GCCCGTAATACCTTCT-1	Invasive
GCCCTAGCCGTCGCGA-1	Invasive
GCCCTGAGGATGGGCT-1	Invasive
GCCGAAATTCCTACGT-1	Invasive
GCCGACCCACGACTGC-1	Invasive
GCCGATTGGCCAAGCT-1	Invasive
GCCGCTTGTGAGAAAC-1	Invasive
GCCGGAAACACATCTT-1	Tumor
GCCGGGTTAGGGTCGC-1	Invasive
GCCGGTCGTATCTCTC-1	Invasive
GCCGTCGGTTTCGGGC-1	Invasive
GCCGTGGAAGAAATGT-1	Tumor
GCCTACGTTCTGTGCA-1	Invasive
GCCTAGCGATCTGACC-1	Invasive
GCCTATAGTGTCAGGG-1	Healthy
GCCTATGCTGGGCCTT-1	Healthy
GCCTATTCCGATATAG-1	Invasive
GCCTATTTGCTACACA-1	Invasive
GCCTCATCTGGAAATA-1	Surrounding tumor
GCCTCCGACAATTCAC-1	Invasive
GCCTCTATACATAGCA-1	Tumor
GCCTGCTACACTGAGA-1	Healthy
GCCTGTCCCGGTGCAT-1	Invasive
GCCTTCAGCCCTACCG-1	Invasive
GCCTTGTATATGCAGT-1	Invasive
GCCTTTGTCAGTGGAC-1	Invasive
GCGAAACGATCGGGAG-1	Invasive
GCGAAGAATCTGACGG-1	Invasive
GCGAAGCCATACCCGT-1	Invasive
GCGAATGGACTAGCGA-1	Invasive
GCGACATGTAAACATC-1	Tumor
GCGACCCAACCATCTG-1	Invasive
GCGACGATAGTTGTAC-1	Invasive
GCGACGGTAGTCTCCT-1	Invasive
GCGAGAAACGGGAGTT-1	Invasive
GCGAGAGGCCATGTAA-1	Healthy
GCGAGAGTTGCGTCCA-1	Tumor
GCGAGCGCATGCTCCC-1	Tumor
GCGAGGCCCGAGCAGA-1	Invasive
GCGAGTTCTGCAAAGA-1	Invasive
GCGATTCTGGAAGCAG-1	Tumor
GCGATTGTTAACGTTA-1	Invasive
GCGCAAATATATTCAA-1	Invasive
GCGCAAGAGCGCGCTG-1	Tumor
GCGCATCCAGTCAGCA-1	Healthy
GCGCCGTTCCACGATA-1	Invasive
GCGCCTCCCACTCCGA-1	Surrounding tumor
GCGCGGTCTAGTAACT-1	Surrounding tumor
GCGCGTCATTGGTACA-1	Tumor
GCGCTAATTGAATAGA-1	Invasive
GCGCTATGCCGAGGCA-1	Invasive
GCGCTGATCCAGACTC-1	Surrounding tumor
GCGCTGCTTTGCATTT-1	Healthy
GCGCTTAAATAATTGG-1	Invasive
GCGGAGAAACTTCGCA-1	Invasive
GCGGATTACTTGTTCT-1	Invasive
GCGGCAAAGTATTGCC-1	Invasive
GCGGCTCTGACGTACC-1	Invasive
GCGGCTTTAGCAAGTT-1	Invasive
GCGGGAACCAGGCCCT-1	Invasive
GCGGGCAGACGGGTGA-1	Invasive
GCGGGCATTACGATGC-1	Surrounding tumor
GCGGTAACCCAAATGA-1	Invasive
GCGGTCCCGGTGAAGG-1	Healthy
GCGGTCCCTAGACGCA-1	Invasive
GCGGTCTTGCTTTCAC-1	Invasive
GCGGTGAACTGCGCTC-1	Healthy
GCGGTTCCCTATCATG-1	Invasive
GCGTAAATGGCCATAA-1	Tumor
GCGTCCCTAAGACATA-1	Invasive
GCGTCGAAATGTCGGT-1	Invasive
GCGTCGCCAGGGTGAT-1	Tumor
GCGTCGTAACATGGTC-1	Invasive
GCGTCTCTGCATTGGG-1	Invasive
GCGTGGTACTGGGTTA-1	Surrounding tumor
GCGTGTATGTCGTATT-1	Tumor
GCGTTCGGAGACCGGG-1	Healthy
GCTAAACCTGAGGTGA-1	Surrounding tumor
GCTAACTGAAGTCTGA-1	Invasive
GCTAAGCCCAGTATGC-1	Invasive
GCTAAGTAAAGGCGAT-1	Surrounding tumor
GCTAAGTAGTTTCTCT-1	Invasive
GCTAATACCGAATGCC-1	Invasive
GCTACAATCGAGGATA-1	Invasive
GCTACAGTACGGACCG-1	Surrounding tumor
GCTACGACTTATTGGG-1	Healthy
GCTACTATAGTAGAGT-1	Surrounding tumor
GCTAGACCGTCTACTG-1	Tumor
GCTAGAGTAGAGATGT-1	Invasive
GCTAGCAGGGAGTGGG-1	Healthy
GCTAGCGATAGGTCTT-1	Invasive
GCTAGGCACCACGGAG-1	Invasive
GCTAGTAGAGCTTGTA-1	Invasive
GCTAGTTTCATTGAGG-1	Invasive
GCTATAAGGGCCAGGA-1	Invasive
GCTATACGTCTCGGAC-1	Invasive
GCTATCATACTCATGG-1	Tumor
GCTATCGCGGCGCAAC-1	Invasive
GCTCAATGTAATACCG-1	Tumor
GCTCATTACTGCATGT-1	Healthy
GCTCCATGCAAAGCAA-1	Invasive
GCTCCCAGTCGGTCCA-1	Tumor
GCTCCGCTCGCTTCAG-1	Tumor
GCTCCTGACATACTGG-1	Invasive
GCTCGCTCATGTCCAA-1	Tumor
GCTCGGAATTTAAAGC-1	Surrounding tumor
GCTCTAAACCCTGACG-1	Invasive
GCTCTATGTTACGTGC-1	Invasive
GCTCTCGGGTACCGAA-1	Invasive
GCTCTTTCCGCTAGTG-1	Surrounding tumor
GCTGAACTCTCCAGGG-1	Surrounding tumor
GCTGAATCTTCCAATC-1	Invasive
GCTGAGGCGTGAGTAT-1	Invasive
GCTGCACGGTTTCTTA-1	Healthy
GCTGCTAAGTAGTCGA-1	Healthy
GCTGCTACTGCGTAGC-1	Surrounding tumor
GCTGCTCTCCGGACAC-1	Invasive
GCTGGACCCAAAGTGG-1	Healthy
GCTGGCATATTCACCT-1	Invasive
GCTGGCGGCGCATGCT-1	Tumor
GCTGGTGACTCGTAGT-1	Healthy
GCTGGTTTAGGCCATA-1	Invasive
GCTGTATTACTGGCCC-1	Invasive
GCTGTTGCTACCGAAC-1	Surrounding tumor
GCTTAATGTAACTAAC-1	Invasive
GCTTACGTAGTTAGTA-1	Tumor
GCTTATGAAGCAGGAA-1	Healthy
GCTTCAGTGGGATTAC-1	Healthy
GCTTCCAGCTTAGATT-1	Invasive
GCTTCCATGTAACCGC-1	Invasive
GCTTCCCGTAAGCTCC-1	Surrounding tumor
GCTTCCGTCCCTAGAC-1	Invasive
GCTTCGACGTTCAATC-1	Invasive
GCTTGAGTGACCTCTG-1	Invasive
GCTTGATGATAATCAG-1	Invasive
GCTTGCAGCACAATTG-1	Healthy
GCTTGGATCGATTAGG-1	Healthy
GCTTTACACAACTGGG-1	Invasive
GCTTTCAGAGGAGGTG-1	Healthy
GCTTTCTATCTCAACT-1	Healthy
GGAAACCTTGTTGAAT-1	Healthy
GGAAACTAAATGGGCC-1	Invasive
GGAAAGGGAATTGAGC-1	Surrounding tumor
GGAAAGTGCCCATGCC-1	Surrounding tumor
GGAACCGTGTAAATTG-1	Invasive
GGAACCTTGACTCTGC-1	Invasive
GGAACGGCCTGCAGCC-1	Surrounding tumor
GGAACTTTGGCGATTA-1	Surrounding tumor
GGAAGCTCGCTTACAG-1	Surrounding tumor
GGAAGGACACCGTATA-1	Surrounding tumor
GGAATAACCTCAAGAA-1	Tumor
GGAATGCGCTAGCGTG-1	Invasive
GGACAACCATGAAGCC-1	Invasive
GGACACAAGTTTACAC-1	Surrounding tumor
GGACACCTCGGTGTTG-1	Invasive
GGACCAACAGGATAAC-1	Healthy
GGACCTACGGTAACGT-1	Healthy
GGACCTCTAGGCCGCC-1	Invasive
GGACGGCTTGCGCAAC-1	Healthy
GGACGGGCGACCAACC-1	Invasive
GGACGTCCATAGTTGG-1	Healthy
GGACTCGACAGCGCAT-1	Invasive
GGACTCGTGAGTGGTC-1	Invasive
GGACTCTTTGACTAAG-1	Invasive
GGAGAAGTCATTGGCA-1	Invasive
GGAGACCAATGTGCTT-1	Healthy
GGAGACGACACCTTTG-1	Healthy
GGAGCAACATTTCAAG-1	Surrounding tumor
GGAGCACCAAGAACTA-1	Surrounding tumor
GGAGCGAGGCCTACTT-1	Invasive
GGAGGATTGAAAGGAG-1	Tumor
GGAGGCCGAAGTCGTC-1	Tumor
GGAGGGCTTGGTTGGC-1	Invasive
GGAGGGTCAAGTAAGA-1	Surrounding tumor
GGAGTGCCGCCCTGGA-1	Invasive
GGAGTTGATTCTGTGT-1	Invasive
GGATACTCATGAATTG-1	Invasive
GGATCAAAGGACGAGG-1	Surrounding tumor
GGATCATCCCGTACGC-1	Healthy
GGATCCCTACCAGCTA-1	Invasive
GGATCCGGAATATACT-1	Invasive
GGATCTTACTGCCCTT-1	Invasive
GGATCTTGACTCAACC-1	Invasive
GGATGAAGATCGCTGA-1	Surrounding tumor
GGATGACGCGAGTTTA-1	Invasive
GGATGCTGGCGTTCCT-1	Surrounding tumor
GGATGGCTTGAAGTAT-1	Invasive
GGATGTCCTTACCGCA-1	Healthy
GGATTAAGCTAAGGTC-1	Surrounding tumor
GGATTAATCATGGACC-1	Invasive
GGATTCAGTACGGTGG-1	Invasive
GGATTCCGCTATACCC-1	Surrounding tumor
GGATTGCTGTGACTCC-1	Surrounding tumor
GGATTTCACTTCTATA-1	Invasive
GGCAAAGGCGCCAATA-1	Invasive
GGCAAATTACTTTACT-1	Invasive
GGCAAGCCAGGGATAG-1	Healthy
GGCAAGCCCATAGTGG-1	Surrounding tumor
GGCAAGGCGAAATAGC-1	Healthy
GGCAATAGTCAATGAG-1	Invasive
GGCACGCTGCTACAGT-1	Invasive
GGCACTCCACTGGGCA-1	Invasive
GGCACTGCGGTGGTTT-1	Invasive
GGCAGCAAACCTATGC-1	Surrounding tumor
GGCAGCGGTAATCCTA-1	Healthy
GGCATACAGGTAGCGG-1	Invasive
GGCATATCGGTTCTGC-1	Surrounding tumor
GGCATCAACGAGCACG-1	Surrounding tumor
GGCATTGAACATCTCA-1	Invasive
GGCCAATTGTATAGAC-1	Invasive
GGCCCAATCTAGAGGG-1	Healthy
GGCCCAGCTGGTTTGC-1	Invasive
GGCCCAGTTATCAGCA-1	Healthy
GGCCCGGAGCATGTCT-1	Tumor
GGCCCGTATACCATGC-1	Healthy
GGCCCTCACCCACTTA-1	Invasive
GGCCGAGACTCTGGTG-1	Invasive
GGCCGCAGGAACCGCA-1	Invasive
GGCCGGCGTCTGCTAT-1	Invasive
GGCCGTTTGGGTTTCA-1	Invasive
GGCCTGCTCTGATGTT-1	Invasive
GGCCTGCTTCTCCCGA-1	Tumor
GGCGAAATCTAACTTG-1	Invasive
GGCGCAGGACATCTTC-1	Invasive
GGCGCATGAATTGATG-1	Invasive
GGCGCGGAGATCTTTC-1	Invasive
GGCGCGTTCGAGTTTA-1	Healthy
GGCGCTCCTCATCAAT-1	Invasive
GGCGCTTCATTCCCTG-1	Invasive
GGCGGAGTAATATTAG-1	Invasive
GGCGGTAGGATCATTG-1	Surrounding tumor
GGCGTACCCTATATAA-1	Tumor
GGCGTAGGGAAAGCTG-1	Invasive
GGCGTCCTATCCGCTG-1	Invasive
GGCTAAAGGGCGGGTC-1	Healthy
GGCTAATGATTGAAAT-1	Healthy
GGCTACTATACACTCC-1	Invasive
GGCTATTAAGTTGTAT-1	Invasive
GGCTCCTCCACCTGTT-1	Invasive
GGCTCGCGTTGAGGTA-1	Healthy
GGCTCGTGCCACCAGC-1	Invasive
GGCTCTGCTCCAACGC-1	Invasive
GGCTGAAATAGCAAAG-1	Healthy
GGCTGAGCATCGTAAG-1	Healthy
GGCTGGCTAGCTTAAA-1	Invasive
GGCTTTCAATAAGGGT-1	Tumor
GGGAAAGAATGCCAAC-1	Invasive
GGGAACGGGAGGTTAG-1	Invasive
GGGAACGGTTTCAGAT-1	Invasive
GGGAAGACGGTCTGTC-1	Invasive
GGGAAGGGCTTTCTCA-1	Invasive
GGGAATGAGCCCTCAC-1	Healthy
GGGACAGAGTTACTCC-1	Invasive
GGGACCCGTATATCTT-1	Surrounding tumor
GGGACTGCATAGATAG-1	Invasive
GGGAGAACTCACAGTA-1	Invasive
GGGAGCGACCGTAGTG-1	Invasive
GGGAGGATGCCCGAAA-1	Invasive
GGGAGTAATGGCTGGC-1	Invasive
GGGAGTTAATGAGGCG-1	Invasive
GGGATCCCAATACAAA-1	Healthy
GGGATGGTCGTAACCG-1	Invasive
GGGATTTACCGCACCT-1	Invasive
GGGCAACCGCACGTGC-1	Invasive
GGGCACGTAGTACTGT-1	Invasive
GGGCAGAGCAATCGTT-1	Tumor
GGGCAGTCAACGCCAA-1	Invasive
GGGCATGCATGTCGAG-1	Invasive
GGGCCATTCGTGCTGG-1	Invasive
GGGCCCGTCTTAAACA-1	Invasive
GGGCCCTACGAAAGGG-1	Surrounding tumor
GGGCCGGCCGAAGTAC-1	Surrounding tumor
GGGCCTATTTAAGTAT-1	Healthy
GGGCGATATGTGTGAA-1	Invasive
GGGCGCAGCGTTACTC-1	Tumor
GGGCGGGTTCCCTACG-1	Invasive
GGGCGGTCCTATTGTC-1	Invasive
GGGCGTACATTTATAT-1	Invasive
GGGCGTCACCACGTAA-1	Invasive
GGGCGTCCACTGGCTC-1	Surrounding tumor
GGGCGTGGTTTCCCAG-1	Tumor
GGGCGTTTACATTCAT-1	Invasive
GGGCTCATCGAACCCA-1	Healthy
GGGCTGCCTAGGGCGA-1	Invasive
GGGCTGGTTAGTCGCG-1	Invasive
GGGTAATGCTGTGTTT-1	Invasive
GGGTACCCACGGTCCT-1	Invasive
GGGTACTTCATGAACT-1	Invasive
GGGTATGTATGCACTT-1	Invasive
GGGTATTCTAGCAAAC-1	Invasive
GGGTCACCGTGACGGT-1	Invasive
GGGTCAGGAGCTAGAT-1	Invasive
GGGTCATGCGTACCAT-1	Surrounding tumor
GGGTCCTTGGAAGAAG-1	Invasive
GGGTCGTGGCAAGTGT-1	Healthy
GGGTCTATCGCTTTCC-1	Surrounding tumor
GGGTGACACCTTAACT-1	Invasive
GGGTGCATATGAAAGC-1	Surrounding tumor
GGGTGGTCCAGCCTGT-1	Tumor
GGGTGTTTCAGCTATG-1	Surrounding tumor
GGGTTCAGACGAACAA-1	Invasive
GGGTTTAGGATAGGAT-1	Tumor
GGTAAACTCTGCGCTG-1	Invasive
GGTAAATGTGCGTTAC-1	Tumor
GGTAACCGGGAGGATA-1	Invasive
GGTAACTATGTATCTG-1	Invasive
GGTACAAACATGCTAT-1	Invasive
GGTACACCAGATTTAT-1	Healthy
GGTACATCTGGGACGA-1	Surrounding tumor
GGTACCATTAAGACGG-1	Surrounding tumor
GGTACGTTGCGGCCGG-1	Invasive
GGTAGAAGACCGCCTG-1	Tumor
GGTAGGCCAATATCAC-1	Invasive
GGTAGTGCTCGCACCA-1	Invasive
GGTATAGTGACACATA-1	Tumor
GGTATTGCCGAGTTTA-1	Invasive
GGTCAAGACTACTTCG-1	Surrounding tumor
GGTCACGTTAGATTCA-1	Invasive
GGTCAGTGGGTCCCAC-1	Healthy
GGTCATTGTAGTCATA-1	Healthy
GGTCGGATAAACGGCG-1	Healthy
GGTCGGCCAGGAGCTT-1	Invasive
GGTCGGTAATTAGACA-1	Invasive
GGTCGTAAGCTCGCAC-1	Invasive
GGTCTCCGTCCAGGTT-1	Invasive
GGTCTCTGAATGGACT-1	Surrounding tumor
GGTCTGAGAATCTGGA-1	Invasive
GGTCTTGAGCGCTCTT-1	Surrounding tumor
GGTGAAACCGGGAATG-1	Surrounding tumor
GGTGAACGGGCTAGCC-1	Invasive
GGTGAAGTACAGGGAT-1	Invasive
GGTGAGATGCAGATAA-1	Invasive
GGTGATAAGGAGCAGT-1	Invasive
GGTGATTTCATCTTGT-1	Invasive
GGTGCAGAGCCTATCG-1	Healthy
GGTGCATAAATGATTA-1	Invasive
GGTGCGGATAAGTGGC-1	Invasive
GGTGCTGATCACAAAG-1	Surrounding tumor
GGTGCTGGTACACATT-1	Invasive
GGTGGACCACGTGTTA-1	Healthy
GGTGGACTGCTCTGGC-1	Invasive
GGTGTAAATCGATTGT-1	Invasive
GGTGTAGGTAAGTAAA-1	Invasive
GGTGTTCTGTTTCTAC-1	Healthy
GGTTACCACCCTCGGG-1	Invasive
GGTTACCCGACACTTT-1	Surrounding tumor
GGTTAGCTATATGTCT-1	Surrounding tumor
GGTTAGGCTTGGAGAA-1	Invasive
GGTTAGTTACGGCGCC-1	Surrounding tumor
GGTTCCCTAGTGTCTC-1	Surrounding tumor
GGTTCGATGCTGAGTT-1	Surrounding tumor
GGTTCGCATTTGCCGT-1	Invasive
GGTTCTACTCGTCTGA-1	Tumor
GGTTGTATCGTGAAAT-1	Tumor
GGTTTAATTACCATCG-1	Invasive
GGTTTAATTGAGCAGG-1	Healthy
GGTTTACAATCTCAAT-1	Invasive
GGTTTAGCCTTTCTTG-1	Tumor
GGTTTCAATCGGTCAG-1	Healthy
GGTTTGACAAGAAGCT-1	Healthy
GGTTTGAGTGCTGGAA-1	Invasive
GGTTTGCGAACACGTA-1	Healthy
GGTTTGTGACCTGAGG-1	Invasive
GTAACAACTGACCTTG-1	Healthy
GTAACATCTAAGATAA-1	Tumor
GTAACTGCCCAAGGAG-1	Invasive
GTAACTTGCGGCAGTC-1	Invasive
GTAAGCGGGCAGTCAG-1	Invasive
GTAAGGATTTGTCGGA-1	Tumor
GTAAGTAACAGTCTGG-1	Invasive
GTAAGTAGGGTATACC-1	Surrounding tumor
GTAAGTCCACACTCTA-1	Surrounding tumor
GTAATAAAGGGCTCCC-1	Surrounding tumor
GTACACTTACCTGAAG-1	Invasive
GTACAGAGGCAAGGGT-1	Surrounding tumor
GTACGACGGCGCTGCG-1	Invasive
GTACGAGATTGCGACA-1	Invasive
GTACGTCACGTATTAA-1	Healthy
GTACGTTTGCCCGTCA-1	Healthy
GTACTAAGATTTGGAG-1	Invasive
GTACTCCCTTATCGCT-1	Invasive
GTACTCCTGGGTATGC-1	Healthy
GTACTGAGGTCGTAAC-1	Invasive
GTACTGCATGAAGCGT-1	Invasive
GTACTGGAGTTAGACC-1	Invasive
GTACTTGGGCACTTCT-1	Invasive
GTAGAAACGGGTGGAG-1	Surrounding tumor
GTAGACAACCGATGAA-1	Surrounding tumor
GTAGACACGCCTGACT-1	Tumor
GTAGACGTCGTTACAT-1	Invasive
GTAGAGGGAGACAAGT-1	Surrounding tumor
GTAGCCAAACATGGGA-1	Healthy
GTAGCGCTGTTGTAGT-1	Surrounding tumor
GTAGCGGCTATACACT-1	Invasive
GTAGCTAGTAAGCGCG-1	Surrounding tumor
GTAGCTCCGGGAGGCT-1	Invasive
GTAGCTTCCTCTTGTT-1	Healthy
GTAGGTGATCCGTGTA-1	Surrounding tumor
GTAGTCGCGGGAATCA-1	Healthy
GTAGTCTACGATATTG-1	Surrounding tumor
GTAGTGAGCAACCTCA-1	Invasive
GTAGTTCGAAGGCGAA-1	Invasive
GTATAATCTCCCGGAT-1	Invasive
GTATAGGACTCAGTAG-1	Invasive
GTATAGTGGCCCATGT-1	Healthy
GTATATGTTACGGCGG-1	Invasive
GTATCAAACGTTAGCT-1	Invasive
GTATCAAGGTACTTCC-1	Surrounding tumor
GTATCAGCTTGGGTTC-1	Invasive
GTATCCTTTGGTAACC-1	Invasive
GTATCGGGACGAGCTG-1	Invasive
GTATCTCAGTCTTGAC-1	Invasive
GTATCTCCCTAACTGT-1	Tumor
GTATCTCGGGCGCTTT-1	Invasive
GTATCTTGTTGCTCAC-1	Surrounding tumor
GTATCTTTCATAACCA-1	Healthy
GTATGAAATTTCACTC-1	Invasive
GTATGACGTGGGAAAC-1	Invasive
GTATGTGGGTCTAGTT-1	Invasive
GTATTAAGGCGTCTAA-1	Invasive
GTATTAGGGTTCGCGT-1	Healthy
GTATTCTGAGAAACGA-1	Invasive
GTATTCTTACCGTGCT-1	Invasive
GTATTTAATGGCATAA-1	Surrounding tumor
GTCAAAGAAGTGGTGT-1	Surrounding tumor
GTCAAAGTTTACATAG-1	Invasive
GTCAACCAGGCCTATA-1	Invasive
GTCAAGCGGACTCGGG-1	Invasive
GTCAATGCTATAATTT-1	Healthy
GTCAATTGTACTGAAG-1	Surrounding tumor
GTCACAAAGTTTCCAA-1	Surrounding tumor
GTCACTCTCCAAATCT-1	Invasive
GTCAGAATAGTCTATG-1	Invasive
GTCAGTTGTGCTCGTT-1	Tumor
GTCAGTTTGGTAGTCG-1	Surrounding tumor
GTCATCTCCTACAGCT-1	Invasive
GTCATGCACCTCCGTT-1	Invasive
GTCATGCGCGAGGGCT-1	Invasive
GTCATGGACATGACTA-1	Invasive
GTCATTAGAGCGAACG-1	Invasive
GTCCAATATTTAGCCT-1	Invasive
GTCCAGGCACGTGTGC-1	Invasive
GTCCATTACTGCTACG-1	Tumor
GTCCCAACGTAAAGTA-1	Invasive
GTCCCGCGACGTTATG-1	Tumor
GTCCGGACCTGAAATT-1	Invasive
GTCCGGCTGAATTGCG-1	Invasive
GTCCGGGTTCACATTA-1	Invasive
GTCCTACAGGCGGCTC-1	Invasive
GTCCTACGAATAGTCT-1	Invasive
GTCCTTCTAGTGGGTT-1	Surrounding tumor
GTCCTTTAATGACTTC-1	Healthy
GTCGAATTTGGGCGCT-1	Invasive
GTCGCGTAACCCGTTG-1	Invasive
GTCGGAAGGATACCAG-1	Healthy
GTCGGATATCTCAGAC-1	Invasive
GTCGGATGTAGCGCGC-1	Surrounding tumor
GTCGGGAAGCAGAAAC-1	Tumor
GTCGGGTGAAGTACCG-1	Invasive
GTCGTACCATCTCGGG-1	Healthy
GTCGTATTGGCGTACA-1	Healthy
GTCGTCAATTATAAGG-1	Invasive
GTCGTCTGGTTGGCTA-1	Surrounding tumor
GTCGTGTCTGGTCATC-1	Surrounding tumor
GTCTAGTGAGCCGCTT-1	Invasive
GTCTATCTGAGTTTCT-1	Invasive
GTCTATTGCATGCTCG-1	Invasive
GTCTATTGGTTCCGGT-1	Surrounding tumor
GTCTCAAGGCCCGGCT-1	Tumor
GTCTCCCGAGTCCCGT-1	Invasive
GTCTCCGCCTCAATAC-1	Invasive
GTCTCCTGCCAGTATG-1	Invasive
GTCTCGACTAAGTTTG-1	Healthy
GTCTCGATCTGCTTTC-1	Surrounding tumor
GTCTCGCCAACACGCC-1	Tumor
GTCTGCCGACTCGACG-1	Surrounding tumor
GTCTGGGCGGTCGAGA-1	Invasive
GTCTTACCACGCCAAG-1	Invasive
GTCTTAGTACAGCCGG-1	Surrounding tumor
GTCTTGAGGAGCAGTG-1	Tumor
GTCTTGTAGCTATTCA-1	Surrounding tumor
GTGAAACGGCGCCACC-1	Healthy
GTGAAACGTGCTCCAC-1	Invasive
GTGAACTCCCATTCGA-1	Surrounding tumor
GTGAAGATTTCAAGTG-1	Healthy
GTGAAGCCGTATAGTC-1	Healthy
GTGACAGCTTCCCACT-1	Invasive
GTGACCGCACACTACG-1	Invasive
GTGACGAGGGTGACCC-1	Tumor
GTGACGCAGGTTTCAT-1	Invasive
GTGACTTCAGTAGTGC-1	Invasive
GTGAGATAACCTTATA-1	Invasive
GTGAGCGTGCTGCACT-1	Invasive
GTGAGGACACTTAAGG-1	Healthy
GTGAGGAGCGGTTGAG-1	Surrounding tumor
GTGAGTCGACTAATAG-1	Invasive
GTGATCAAGCGTGCAC-1	Invasive
GTGATCACTAACGCCT-1	Surrounding tumor
GTGATCATAGATCTGC-1	Invasive
GTGATCCTTGTCATGA-1	Invasive
GTGATGCACAACATCT-1	Healthy
GTGATTCGCCGCTCAA-1	Invasive
GTGCAACAAATGTGGC-1	Invasive
GTGCACCAGCTTCAAC-1	Invasive
GTGCACGAAAGTGACT-1	Surrounding tumor
GTGCCATCACACGGTG-1	Invasive
GTGCCGCTTCAAAGGT-1	Invasive
GTGCCTCAGTGTACGG-1	Healthy
GTGCCTGAGACCAAAC-1	Invasive
GTGCGAAATCGAACAC-1	Invasive
GTGCGACAGGGAGTGT-1	Tumor
GTGCGCAGCTTGCTCC-1	Invasive
GTGCGGGACCATCGGC-1	Surrounding tumor
GTGCGGGTCTCCAAAT-1	Invasive
GTGCGTGTATATGAGC-1	Invasive
GTGCTCAAGTACTGTC-1	Invasive
GTGCTTACATCAGCGC-1	Surrounding tumor
GTGGAACCTACATGCG-1	Surrounding tumor
GTGGACCAACCCGATT-1	Invasive
GTGGACGCATTTGTCC-1	Tumor
GTGGACGTGCTGAGAC-1	Invasive
GTGGAGCGTTTACCGA-1	Invasive
GTGGCAAACAGCGGCA-1	Invasive
GTGGCCGGTTTCTCGG-1	Invasive
GTGGCGGGCCGTAGCT-1	Tumor
GTGGCGGTCCCAGCGT-1	Surrounding tumor
GTGGCTGTTTCTGTTC-1	Invasive
GTGGGAACAAACCGGG-1	Invasive
GTGGGAAGACTGAATC-1	Surrounding tumor
GTGGGCTTAGACACAC-1	Invasive
GTGGTCAGCGAAGTAT-1	Healthy
GTGGTTACTTCTTTCG-1	Surrounding tumor
GTGGTTTCCGCCTTTC-1	Invasive
GTGTACCTTGGCTACG-1	Invasive
GTGTATATCAGCGGGC-1	Tumor
GTGTATGACTTTAAAG-1	Surrounding tumor
GTGTCAGTGTACGTGG-1	Invasive
GTGTCGTATAGCGTTC-1	Tumor
GTGTCGTATTCACCTT-1	Healthy
GTGTGAATAACTTAGG-1	Surrounding tumor
GTGTTACTATGCGTCC-1	Healthy
GTTAAAGTAGGACTGG-1	Surrounding tumor
GTTAACATCACTTAAA-1	Tumor
GTTAACTATGTTGTCA-1	Tumor
GTTAAGGGTGCGATGT-1	Tumor
GTTAAGTTAGAGTGGG-1	Tumor
GTTACAATTGGTGACG-1	Invasive
GTTACCTACAACTTGC-1	Healthy
GTTACTTTGGGCCTAG-1	Invasive
GTTAGAGTGTGCCGCT-1	Tumor
GTTAGCCCATGACATC-1	Invasive
GTTAGCCGTAAATCAA-1	Surrounding tumor
GTTAGGCTACCCGTTT-1	Invasive
GTTATAATACGGTGAA-1	Surrounding tumor
GTTATATCAGGAGCCA-1	Healthy
GTTATATTATCTCCCT-1	Healthy
GTTATCAAGCTATCGA-1	Invasive
GTTATCACCTTCTGAA-1	Tumor
GTTATTAAATACGACC-1	Surrounding tumor
GTTATTAACGTGGGAG-1	Surrounding tumor
GTTCAATCTATGTCAA-1	Surrounding tumor
GTTCACAGGAGTCTAG-1	Invasive
GTTCAGTCGCCAAATG-1	Invasive
GTTCATCGTTTGGCTG-1	Tumor
GTTCCAAGACAGCGAC-1	Invasive
GTTCCAGTCTGACCAT-1	Invasive
GTTCCCGTAAACATAT-1	Surrounding tumor
GTTCCGTCCGCCTGCA-1	Invasive
GTTCGACAATTGTATA-1	Invasive
GTTCGCCATAAGTGCC-1	Invasive
GTTCGCTGAGACGTCT-1	Surrounding tumor
GTTCGGAGCACTCAAC-1	Surrounding tumor
GTTCGGATCGGGAACA-1	Tumor
GTTCGGGCGTACCATT-1	Tumor
GTTCGTCTAAAGAACT-1	Invasive
GTTCGTCTGGGTCCCT-1	Healthy
GTTCTTCCCTCGATGT-1	Invasive
GTTCTTGTAACTCAAT-1	Invasive
GTTGAACCGGTTCCAT-1	Invasive
GTTGAGTCCCGCCGGT-1	Tumor
GTTGCACGGAGTTTCG-1	Invasive
GTTGCGCTAACATTAC-1	Surrounding tumor
GTTGCGGACGGTCAGG-1	Surrounding tumor
GTTGGACCGCATCAGG-1	Healthy
GTTGGATTCAGTGGCT-1	Healthy
GTTGGATTGAGAACAC-1	Healthy
GTTGGATTTGCGTTGG-1	Invasive
GTTGGTCATGCTATCC-1	Tumor
GTTGTAGATTTATGAG-1	Invasive
GTTGTCGTGTTAGTTG-1	Invasive
GTTGTTACATTGCGCT-1	Healthy
GTTTACGTTCCATCTG-1	Healthy
GTTTCAAACGAGTTGT-1	Surrounding tumor
GTTTCATATCGTCGCT-1	Invasive
GTTTCCTGGAGGGTGA-1	Invasive
GTTTCTAGAGGCGCGG-1	Invasive
GTTTCTGCAGTCTCCC-1	Invasive
GTTTGACCAAATCCTA-1	Invasive
GTTTGGCCCAAGTTAT-1	Invasive
GTTTGGCCGCTCAGCG-1	Invasive
GTTTGGCGTCAGGCAC-1	Surrounding tumor
GTTTGGGCTTGTGAGC-1	Healthy
GTTTGGGTTTCGCCCG-1	Invasive
GTTTGGTGATCGGTGC-1	Invasive
TAAACGTCGTCAATGA-1	Invasive
TAAAGACAACCCTTTA-1	Surrounding tumor
TAAAGAGCCCGAAACC-1	Invasive
TAAAGCGGTATTTCCA-1	Invasive
TAAAGCGTTAGGAGAA-1	Healthy
TAAAGCTGCAATAGGG-1	Healthy
TAAAGTGCACGTCTCG-1	Invasive
TAAATCTTTACACCTC-1	Healthy
TAAATGAATCCGTTTC-1	Invasive
TAAATGCCGTCTCATG-1	Healthy
TAAATTGTGGGTAAAG-1	Invasive
TAAATTTAGTAACACC-1	Invasive
TAACAAAGGGAGAAGC-1	Invasive
TAACAATATTTGTTGC-1	Surrounding tumor
TAACAGCGTTTGTGCT-1	Invasive
TAACAGGTTCCCTTAG-1	Invasive
TAACATACAATGTGGG-1	Invasive
TAACATACACGCGATC-1	Invasive
TAACCGCCCGCAGTGC-1	Invasive
TAACCTACCGTCCGAG-1	Surrounding tumor
TAACCTAGGGAGTCCA-1	Surrounding tumor
TAACGCTTTGAGAGCG-1	Surrounding tumor
TAACTATCGAAGGTCC-1	Invasive
TAACTATTACGCCAAA-1	Surrounding tumor
TAACTCATCCGCGCGG-1	Invasive
TAACTCCATGGAGGCT-1	Invasive
TAACTGAAATACGCCT-1	Invasive
TAAGAGGGACAGGGAC-1	Invasive
TAAGCAGGCGACACGC-1	Surrounding tumor
TAAGCCCTTACGACCA-1	Healthy
TAAGCGCGAATCAAAT-1	Invasive
TAAGGAACTTGTGGGA-1	Invasive
TAAGGCAACATAAGAT-1	Invasive
TAAGGCCCGTCACCCT-1	Tumor
TAAGGCTGAATCCCTC-1	Tumor
TAAGGGCCTGTCCGAT-1	Invasive
TAAGGGCTGGGAGAGG-1	Surrounding tumor
TAAGTAAATGTGCCGC-1	Healthy
TAAGTAACATCTTGAC-1	Invasive
TAAGTCGCCGAGTATC-1	Invasive
TAAGTTGCGACGTAGG-1	Invasive
TAATAAACAAGGAGAT-1	Surrounding tumor
TAATACACAGTAGTAT-1	Invasive
TAATACTAGAACAGAC-1	Invasive
TAATAGAACAGAGTTA-1	Surrounding tumor
TAATAGGTCACCAGAA-1	Invasive
TAATAGTGACGACCAG-1	Surrounding tumor
TAATATTGAAATTCGC-1	Invasive
TAATCGATCCGTACGT-1	Healthy
TAATGAAAGACCCTTG-1	Surrounding tumor
TAATTACGTCAGTAGA-1	Invasive
TAATTAGATGGATATG-1	Invasive
TAATTAGGACATCCGT-1	Tumor
TAATTGCGCTGATTAC-1	Invasive
TAATTGGAATCGGGAA-1	Healthy
TACAACAGCGCATACA-1	Invasive
TACAACGCACAACTCA-1	Invasive
TACAAGCTGTTCACTG-1	Tumor
TACAAGGGCTTCTTTA-1	Invasive
TACAAGTCTCGTGCAT-1	Invasive
TACACAGCCGTGGTGC-1	Invasive
TACACCGTCGTTAGTC-1	Healthy
TACACCTCTTCGAATC-1	Invasive
TACAGAAACGGTGGGC-1	Invasive
TACATAGGCATACACC-1	Invasive
TACATCCCTATCCCTG-1	Surrounding tumor
TACATTTCTAACGTGC-1	Invasive
TACCAAATAGCCCAGA-1	Tumor
TACCAATAAAGTACCA-1	Tumor
TACCAGAAGTAGGTTC-1	Invasive
TACCAGCTAGGTTTAA-1	Surrounding tumor
TACCAGGAATCCCGTC-1	Invasive
TACCGAATAATTGTAA-1	Invasive
TACCGCGGACTTGCAG-1	Healthy
TACCGGCTCACTGCCC-1	Healthy
TACCGGTCGTTTCCAT-1	Invasive
TACCGTAGGTTAACTA-1	Tumor
TACCGTGCCTCGGACC-1	Healthy
TACCTACTCCCAGTAT-1	Tumor
TACCTCACGCTTGTAC-1	Invasive
TACCTCAGTTGTCTGT-1	Invasive
TACCTCCACACCAATG-1	Invasive
TACCTGCTGCACTGTG-1	Invasive
TACCTTAAGATTTCCC-1	Surrounding tumor
TACGAACACGACTTCA-1	Surrounding tumor
TACGACGCTTGCTGCG-1	Invasive
TACGACTGCCTCTTAG-1	Healthy
TACGAGAACTTCACGT-1	Invasive
TACGATGTTGATCATC-1	Invasive
TACGCAGTTCTTTCCT-1	Invasive
TACGCCATATTCTAAT-1	Invasive
TACGCCGAGGGTACCC-1	Invasive
TACGCCTCCATTCCGA-1	Tumor
TACGCTATAGAAACCT-1	Tumor
TACGCTCCTAGAACTG-1	Invasive
TACGCTCGGTATTGGA-1	Surrounding tumor
TACGCTGCACGGTCGT-1	Invasive
TACGCTGCTGTGTTAA-1	Invasive
TACGGAAGCCAAACCA-1	Invasive
TACGGCATGGACGCTA-1	Surrounding tumor
TACGGGATGCTAGCAG-1	Surrounding tumor
TACGGGTAATAACATA-1	Invasive
TACGTAAAGCGGAGTG-1	Invasive
TACGTACTAGTGCTGA-1	Invasive
TACGTGCACTATGCTG-1	Invasive
TACGTGGGCCCAGGGC-1	Invasive
TACGTTTACCGGCAAT-1	Invasive
TACTACGTGCAATGCG-1	Invasive
TACTCCTCTAGTTGAC-1	Invasive
TACTCGTTTGAATCAA-1	Invasive
TACTCTCCGAACAAAT-1	Surrounding tumor
TACTCTTACTTTACTG-1	Tumor
TACTGCAATCAATTAC-1	Healthy
TACTGGACAGCTCGGC-1	Invasive
TACTGTTTCTCTGGTA-1	Surrounding tumor
TACTTAAACATGTACA-1	Invasive
TACTTTACTGAGCCGG-1	Healthy
TACTTTCCGCACGCCA-1	Surrounding tumor
TAGAAACCACTAAGTA-1	Tumor
TAGAAAGGTGGCGCTA-1	Invasive
TAGAATAGCCGATGAA-1	Invasive
TAGAATTAAGGGCAAC-1	Tumor
TAGACGAAACGCCAAT-1	Tumor
TAGACGCCCGTACCGG-1	Healthy
TAGACTACCTAGCGTT-1	Tumor
TAGACTCAGTTGGCCT-1	Invasive
TAGAGATCATGCAACT-1	Surrounding tumor
TAGAGCTACGAAGAAC-1	Invasive
TAGAGGGAGTTTATCT-1	Invasive
TAGAGGTTCTACTTGT-1	Invasive
TAGAGTCTAAGCGAAC-1	Invasive
TAGAGTGTTCCGGGTA-1	Invasive
TAGATATGGACTGGAA-1	Invasive
TAGATCCGAAGTCGCA-1	Tumor
TAGATGGTTCCTTACT-1	Invasive
TAGATTCAAAGTGCGG-1	Invasive
TAGATTCCTGGTTATT-1	Invasive
TAGATTCTCTAGCAAA-1	Invasive
TAGCAACCTGTCACAA-1	Invasive
TAGCAGATACTTAGGG-1	Invasive
TAGCAGTATGACTAAA-1	Invasive
TAGCCATTTCAAAGTC-1	Invasive
TAGCCGGCGGTCAGCG-1	Surrounding tumor
TAGCGTCCCTCGATTG-1	Surrounding tumor
TAGCGTCCGGTGTGGT-1	Tumor
TAGCGTTGGGTCTTAC-1	Invasive
TAGCTAAGTCCGGGAG-1	Invasive
TAGCTAGTGATGATGG-1	Invasive
TAGCTCAGATCCTAGT-1	Healthy
TAGCTGATGTGAAGCG-1	Surrounding tumor
TAGGAACAGCCTCCAG-1	Surrounding tumor
TAGGAGGCTCGAGAAC-1	Invasive
TAGGCATGTTACGCCA-1	Surrounding tumor
TAGGCCTATATAGTCT-1	Invasive
TAGGCGATGAGGTCTC-1	Invasive
TAGGCGGCTGCAAAGA-1	Invasive
TAGGCTAAAGTGGCAC-1	Invasive
TAGGGAGCTTGGGATG-1	Surrounding tumor
TAGGGTGTTTCAAGAG-1	Invasive
TAGGTCCAAGTAAGGA-1	Invasive
TAGGTCGCCGGAACTG-1	Surrounding tumor
TAGGTGACGATAACCT-1	Tumor
TAGGTGAGCCCTACTC-1	Invasive
TAGGTGCTCGCCTAGC-1	Invasive
TAGGTGTTCCACAGAT-1	Tumor
TAGGTTCGAGTTCGTC-1	Invasive
TAGGTTCTGCTGAGAA-1	Invasive
TAGTACCACAACTTTC-1	Invasive
TAGTACCTTAGTGGTC-1	Invasive
TAGTAGCTTATACCAG-1	Invasive
TAGTCCCGGAGACCAC-1	Invasive
TAGTCCGCAGAGAATG-1	Invasive
TAGTCCGTATGCATAA-1	Invasive
TAGTCCTGCACTAAGC-1	Invasive
TAGTCGATCACGGGTT-1	Surrounding tumor
TAGTCTAACAACGAGA-1	Invasive
TAGTCTGCGGCACATT-1	Invasive
TAGTCTGTGACGTTGC-1	Healthy
TAGTCTTTCCGAATTG-1	Surrounding tumor
TAGTGCCCTCCAGAGT-1	Invasive
TAGTGGAACTCATACA-1	Surrounding tumor
TAGTGTCAGAAACGGC-1	Invasive
TAGTTAAGATAGGATA-1	Surrounding tumor
TAGTTTATTCTTGCTT-1	Invasive
TATAAATCCACAAGCT-1	Invasive
TATAAGTGAGGATAGC-1	Invasive
TATACACGCAAAGTAT-1	Invasive
TATACCGAGTGCCACA-1	Surrounding tumor
TATACGCGTCATCACT-1	Tumor
TATACTCATGCGGCAA-1	Invasive
TATAGAGTCGCTTGAA-1	Invasive
TATAGATGGTCGCAGT-1	Tumor
TATAGGGTACTCATGA-1	Invasive
TATAGTTAGGTGTACT-1	Invasive
TATATAGGGCTTTACG-1	Invasive
TATATATCGAGAAATG-1	Invasive
TATATCAAAGTGATCT-1	Invasive
TATATCCCTGGGAGGA-1	Surrounding tumor
TATATTACAAATGTCG-1	Healthy
TATATTCGCGTCGATA-1	Tumor
TATCACAGCACGGGCA-1	Tumor
TATCACCATGTAAAGT-1	Healthy
TATCACCCAACCGACC-1	Healthy
TATCACTTCGAGTAAC-1	Healthy
TATCCAATTGGTTATC-1	Tumor
TATCCATATCATGCGA-1	Invasive
TATCCATCTCGGTTAG-1	Invasive
TATCCGCACCGTCGGG-1	Healthy
TATCCTATCAACTGGT-1	Invasive
TATCCTGCATGGGAAT-1	Invasive
TATCGATCTATGCATA-1	Surrounding tumor
TATCGATGATTAAACG-1	Invasive
TATCTACAGAGGTAAT-1	Invasive
TATCTACCACAGCGGG-1	Invasive
TATCTGAGCCGATATT-1	Invasive
TATCTTGCAATACAAC-1	Invasive
TATGAAGAATTAAGGT-1	Invasive
TATGAAGACAGGTGCG-1	Invasive
TATGATAAATCTAACG-1	Tumor
TATGATCCGGCACGCC-1	Surrounding tumor
TATGATCTTCTCTTTA-1	Invasive
TATGATTCTGCTTGGT-1	Invasive
TATGCTCCCTACTTAC-1	Invasive
TATGGAGTTTCTCGTT-1	Invasive
TATGGATGTGCTACGC-1	Surrounding tumor
TATGGCCCGGCCTCGC-1	Invasive
TATGGGACCGAGCAGG-1	Invasive
TATGGGTACGTATCGT-1	Invasive
TATGGTCTGAGTAACA-1	Invasive
TATGGTTAGTGGGAGA-1	Tumor
TATGTAAAGTGCTTAA-1	Invasive
TATGTCAAGACCGACT-1	Surrounding tumor
TATGTCTCATTGTGCC-1	Invasive
TATTAACACCAAAGCA-1	Invasive
TATTACCATCCTGCTT-1	Surrounding tumor
TATTATGTTTGCCTGC-1	Invasive
TATTCAATTCTAATCC-1	Invasive
TATTCCGAGCTGTTAT-1	Invasive
TATTCCGGCAGTCCTA-1	Tumor
TATTCCTCCGCCCACT-1	Surrounding tumor
TATTCGTGCCAGAATA-1	Invasive
TATTGACATTTCTGCC-1	Tumor
TATTGCCGGGCTTGTA-1	Invasive
TATTTAGTCTAGATCG-1	Invasive
TATTTATACCGAGTAG-1	Surrounding tumor
TATTTGATTTGCACAG-1	Surrounding tumor
TATTTGTTACCCTTTA-1	Surrounding tumor
TCAAACAACCGCGTCG-1	Invasive
TCAAACTTAGATTGTT-1	Invasive
TCAAAGTCACGGCGTC-1	Invasive
TCAAATTGTTGTGCCG-1	Invasive
TCAAATTTGAGACTCA-1	Tumor
TCAACAAAGATAATTC-1	Surrounding tumor
TCAACACATTGGGTAA-1	Invasive
TCAACATAGCGCCCTA-1	Invasive
TCAACATCGACCGAGA-1	Surrounding tumor
TCAACCATGTTCGGGC-1	Surrounding tumor
TCAACGAGGAGACAAA-1	Invasive
TCAACGCAGGAAATAA-1	Surrounding tumor
TCAACGCGACCGGCAG-1	Invasive
TCAACTAACGTATAAC-1	Invasive
TCAACTGCAGAGTCAG-1	Tumor
TCAAGAAATACTAGCT-1	Tumor
TCAAGCGCGGACGGTA-1	Tumor
TCAAGGTTACTACACC-1	Surrounding tumor
TCAATACGCCGTCATG-1	Tumor
TCAATATACAGGAGGC-1	Invasive
TCAATCCGGGAAGTTT-1	Invasive
TCACAAACCGAGGTAC-1	Invasive
TCACAGATCCTCAAAC-1	Invasive
TCACAGGTTATTGGGC-1	Invasive
TCACATCTTATCTGAT-1	Surrounding tumor
TCACCCTCTTAAGATT-1	Invasive
TCACCGCTCGGCACTC-1	Healthy
TCACGATGTCCGTGGA-1	Surrounding tumor
TCACGCATTGTAGATC-1	Invasive
TCACGGCCCAAGAGAG-1	Invasive
TCACGGTCATCGCACA-1	Invasive
TCACGTGCCCGATTCA-1	Invasive
TCACTACGACCAATGC-1	Healthy
TCACTATCCCTTCGGT-1	Invasive
TCACTCGTGCAACGGC-1	Healthy
TCAGAACCTCCACAGG-1	Surrounding tumor
TCAGAACGGCGGTAAT-1	Surrounding tumor
TCAGAGGACGCGTTAG-1	Surrounding tumor
TCAGCAAATGCATCTC-1	Invasive
TCAGCAGTAGGCCCTG-1	Invasive
TCAGCCAATCCGTAAA-1	Invasive
TCAGCGCACGCCGTTT-1	Invasive
TCAGGGCGCAAACTCG-1	Surrounding tumor
TCAGGGTGCACGAAAC-1	Surrounding tumor
TCAGGGTGTAACGTAA-1	Invasive
TCAGGTTCTTTGAGAA-1	Invasive
TCAGTACTGACCCGCG-1	Surrounding tumor
TCAGTAGGGACTATAA-1	Invasive
TCAGTGTATACGTCAT-1	Invasive
TCAGTTACGGAATGAT-1	Tumor
TCATACTTACAGATCC-1	Invasive
TCATATGAGCTTTGTT-1	Tumor
TCATCACTCGAGCTCG-1	Invasive
TCATCCCAGAGGGTGG-1	Surrounding tumor
TCATCCTCAGCTGCTT-1	Invasive
TCATCGATGGTCCCAA-1	Invasive
TCATGCAGGTTCTCAT-1	Surrounding tumor
TCATTCGTATAATTTG-1	Healthy
TCATTTAAGTCTCCGA-1	Surrounding tumor
TCATTTAGAAGTGTGA-1	Surrounding tumor
TCCAACTCAGCTATCT-1	Invasive
TCCAACTTTAAATTCT-1	Invasive
TCCAAGCCTAGACACA-1	Invasive
TCCAATAAAGGCTACC-1	Invasive
TCCACAATGGTTTACG-1	Invasive
TCCACATCGTATATTG-1	Invasive
TCCACCAAGACATAGG-1	Invasive
TCCACCTCTAGCCTTT-1	Surrounding tumor
TCCACTTTATCTAGGT-1	Invasive
TCCAGAGCACCGGTTC-1	Invasive
TCCAGATGTACGCCAA-1	Healthy
TCCAGCGCTATAAGCG-1	Surrounding tumor
TCCAGGCAGGACGATC-1	Invasive
TCCAGGCGAGTACGGT-1	Invasive
TCCAGGGTATATACGA-1	Tumor
TCCATCAATACTAATC-1	Invasive
TCCATTAGTTGGATAG-1	Invasive
TCCATTGTGACCTCGT-1	Tumor
TCCCAAACAGACAACG-1	Healthy
TCCCAAAGACGAAGGA-1	Invasive
TCCCAAAGCCCTAAAT-1	Tumor
TCCCACTCTCTTCCGG-1	Surrounding tumor
TCCCAGCTTTAGTCTG-1	Invasive
TCCCAGGCTTAGCTAA-1	Invasive
TCCCGCCTATGTGCGT-1	Surrounding tumor
TCCCGCGTACTCCTGG-1	Invasive
TCCCGGGTGTGCTGCT-1	Invasive
TCCCGGTCAGGAATTT-1	Invasive
TCCCGTCAGTCCCGCA-1	Invasive
TCCCGTCGCGTCATAG-1	Surrounding tumor
TCCCTAGATCAATAGG-1	Surrounding tumor
TCCCTCTTCTCAAGGG-1	Surrounding tumor
TCCCTGGCGTATTAAC-1	Invasive
TCCCTGGCTCGCTGGA-1	Invasive
TCCCTTAGATTACTCG-1	Surrounding tumor
TCCCTTGTCTGAAACT-1	Invasive
TCCGAACTTGGCTTAC-1	Surrounding tumor
TCCGAAGTAGTCACCA-1	Healthy
TCCGAATGGTCCTGAG-1	Surrounding tumor
TCCGACCGCTAATCAA-1	Invasive
TCCGAGAAGGCTAAGC-1	Surrounding tumor
TCCGATAATTGCCATA-1	Invasive
TCCGATGACTGAGCTC-1	Surrounding tumor
TCCGATGGTGCGACAT-1	Invasive
TCCGATTACATTGCCG-1	Invasive
TCCGCCTGTCTACAAG-1	Tumor
TCCGCGGCAGCATCTG-1	Invasive
TCCGCGGCCCAATGAA-1	Invasive
TCCGCTGTCATCCCGG-1	Surrounding tumor
TCCGGAGGAAGGGCTG-1	Healthy
TCCGGCCTAGCGTACA-1	Healthy
TCCGGCCTGCATCGAT-1	Surrounding tumor
TCCGGGCTTGACGGGA-1	Invasive
TCCGTAACCACAATCC-1	Invasive
TCCGTTAAGCTAATAT-1	Invasive
TCCGTTTAGCCTTGAA-1	Invasive
TCCTAAAGATTCAGAC-1	Invasive
TCCTAAATTGGGAAGC-1	Tumor
TCCTAACCGTCGGGCA-1	Invasive
TCCTAGCAAAGAAGCT-1	Invasive
TCCTATCATAGGTAAC-1	Surrounding tumor
TCCTCCTAAGACATTC-1	Surrounding tumor
TCCTCGGGCTGGGCTT-1	Invasive
TCCTCTACGAGATGGC-1	Surrounding tumor
TCCTCTCCAGTTGTCC-1	Invasive
TCCTCTGGCCCATTAG-1	Surrounding tumor
TCCTGCCAACTGGAGA-1	Surrounding tumor
TCCTGCGTTGATACTC-1	Invasive
TCCTGGCGCTGCCTGG-1	Healthy
TCCTTACGACGGTCCG-1	Surrounding tumor
TCCTTCAGTGGTCGAA-1	Surrounding tumor
TCCTTGTCCTTTAATT-1	Invasive
TCCTTTAAATCCGCTT-1	Invasive
TCCTTTCTTACGCTTA-1	Invasive
TCGAAATTTAGGACCA-1	Invasive
TCGAAGAACCGAGCAC-1	Tumor
TCGAATATCCCGCAGG-1	Invasive
TCGACAACTGAACCCG-1	Invasive
TCGACTGACGATGGCT-1	Invasive
TCGAGACCAACACCGT-1	Invasive
TCGAGCCAGGCAGGCC-1	Invasive
TCGAGGGCAACAGACG-1	Surrounding tumor
TCGATAGGCTAGTCGC-1	Invasive
TCGCACCAGGAGGCAG-1	Surrounding tumor
TCGCATAAAGGGCGCA-1	Surrounding tumor
TCGCATCCCTAAGTGT-1	Invasive
TCGCATTCAATGACTT-1	Invasive
TCGCCCAACTGACTCC-1	Healthy
TCGCCGAAGTTGCGTC-1	Invasive
TCGCCGACATATTCGC-1	Invasive
TCGCCGGTCGATCCGT-1	Invasive
TCGCCTCCTTCGGCTC-1	Surrounding tumor
TCGCGCGTTTACATGA-1	Surrounding tumor
TCGCGTAGCAGTGTCC-1	Invasive
TCGCGTCCAGAAGGTC-1	Invasive
TCGCTAAACCGCTATC-1	Surrounding tumor
TCGCTACTGGCTTTGA-1	Invasive
TCGCTCGATATATTCC-1	Surrounding tumor
TCGCTCGGCACCAGCG-1	Healthy
TCGCTGCCAATGCTGT-1	Invasive
TCGCTGGGCGGATTGT-1	Invasive
TCGCTGTGCGTAAATC-1	Invasive
TCGCTTAATTACGAAG-1	Healthy
TCGCTTTAAACGTTTG-1	Surrounding tumor
TCGGAATGACCATCAA-1	Tumor
TCGGAATGCGCTCTGA-1	Invasive
TCGGACGCCCAGCCCA-1	Invasive
TCGGAGAGTATCGGGA-1	Surrounding tumor
TCGGAGTACATGAGTA-1	Invasive
TCGGCGAACCCAAACC-1	Surrounding tumor
TCGGCGTACTGCACAA-1	Invasive
TCGGCTAACTTCCCTT-1	Tumor
TCGGCTTGTATCGACG-1	Invasive
TCGGGAACGTGCCTAG-1	Surrounding tumor
TCGGGAGACAGCGTAC-1	Tumor
TCGGGATTCAAACATA-1	Surrounding tumor
TCGGGCCGTCGTGGTA-1	Invasive
TCGGGTGAAACTGCTA-1	Invasive
TCGGTCCCGACAATAG-1	Invasive
TCGGTCCCTGACTCCA-1	Surrounding tumor
TCGGTGACCGCTCCGG-1	Healthy
TCGGTTAGCCATGTAG-1	Healthy
TCGTAAGACGACATTG-1	Invasive
TCGTAAGCTCCGAGGA-1	Healthy
TCGTACCGACGTCAAG-1	Invasive
TCGTATAGTGCAATTA-1	Invasive
TCGTATTACCCATTGC-1	Invasive
TCGTATTTCGTCCGGA-1	Tumor
TCGTCAAGTACGCGCA-1	Invasive
TCGTCACACTGTTAGC-1	Surrounding tumor
TCGTCCGCTGGCGTCT-1	Invasive
TCGTCCGGGTACACTC-1	Healthy
TCGTCTTAGGCGTTAA-1	Invasive
TCGTGTATTGGTCACG-1	Surrounding tumor
TCGTGTCACGCTGACA-1	Surrounding tumor
TCGTGTTCGACCACAA-1	Tumor
TCGTTCGTTATTATGT-1	Surrounding tumor
TCGTTGGCTCGTCAAT-1	Invasive
TCGTTTACGCGACCCT-1	Invasive
TCTAAAGAACAGTCTC-1	Invasive
TCTAACCTAGCCTGCG-1	Invasive
TCTAATACTGCCTCAG-1	Invasive
TCTACACGTTCATGCA-1	Healthy
TCTACCCAATAGAGAG-1	Tumor
TCTACCCGCATCATTT-1	Invasive
TCTACCGTCCACAAGC-1	Invasive
TCTACGGGCTCAGTTG-1	Healthy
TCTAGCAATCTCCGCC-1	Invasive
TCTAGCATCTTCGATG-1	Invasive
TCTAGCATGCCCAGAA-1	Healthy
TCTAGGTGGCGACGCT-1	Healthy
TCTAGTGATATCGTGG-1	Tumor
TCTAGTTATCAGAAGA-1	Invasive
TCTATAGGTGGGTAAT-1	Invasive
TCTATCATGCAGTTAC-1	Invasive
TCTATCCGATTGCACA-1	Surrounding tumor
TCTATCGGTCGCAACA-1	Invasive
TCTATGCTATAACGAC-1	Invasive
TCTATTACGCTGGCGA-1	Invasive
TCTATTACTAGAGGAT-1	Surrounding tumor
TCTCAAATCAATCGGG-1	Invasive
TCTCAGGCTACTCGCT-1	Invasive
TCTCATGAGATAGGGT-1	Surrounding tumor
TCTCCAACGTAGGTTA-1	Surrounding tumor
TCTCCACAAGTTGAAT-1	Invasive
TCTCCCTGGGCAGCGT-1	Tumor
TCTCGAACGAGGTCAC-1	Healthy
TCTCGACGTATCGCCG-1	Surrounding tumor
TCTCGAGGAGGTTCGC-1	Surrounding tumor
TCTCGGCTCCAGGACT-1	Invasive
TCTCTAATAGCTGGTA-1	Invasive
TCTCTCGCCGCACATA-1	Surrounding tumor
TCTCTTACCGCGAACC-1	Invasive
TCTGAACCGGTCGGCT-1	Invasive
TCTGAACTCGTACCCG-1	Surrounding tumor
TCTGAAGCACGTGGTC-1	Tumor
TCTGAATTCCGTACAA-1	Healthy
TCTGACGGGCTAACCC-1	Surrounding tumor
TCTGACTGTAATGGTT-1	Invasive
TCTGAGCAATTGACTG-1	Surrounding tumor
TCTGATCGGGTGCTAG-1	Tumor
TCTGATGTATTCTGTC-1	Surrounding tumor
TCTGCATACCTTGCTT-1	Invasive
TCTGCCAGAAACTGCA-1	Invasive
TCTGCGAATCGTTCGC-1	Healthy
TCTGCGTCCGGTTTCT-1	Invasive
TCTGGGAACCTTTGAA-1	Tumor
TCTGGGTAGCGCTCAT-1	Invasive
TCTGTCATACAAGAGC-1	Invasive
TCTGTGATGGAGGTTG-1	Healthy
TCTGTGCCATCATAGT-1	Invasive
TCTGTTACCCAGCATA-1	Surrounding tumor
TCTTACAGAGGTACCG-1	Invasive
TCTTACCGGAACTCGT-1	Surrounding tumor
TCTTACGGCATCCGAC-1	Surrounding tumor
TCTTACTTATGCCTCT-1	Surrounding tumor
TCTTAGAGCTCCAATT-1	Tumor
TCTTAGAGTGAACTCT-1	Tumor
TCTTATGGGTAGTACC-1	Surrounding tumor
TCTTCCCATGGGCACA-1	Healthy
TCTTCGAATAGACGTT-1	Invasive
TCTTCGATACCAATAA-1	Invasive
TCTTCGCGGTGAGAGG-1	Tumor
TCTTCTATAACCCGCC-1	Surrounding tumor
TCTTGATGCGTAGCGA-1	Invasive
TCTTGCTCCCGATACT-1	Surrounding tumor
TCTTGGTAACACCAAA-1	Surrounding tumor
TCTTTAAGACTATGAA-1	Surrounding tumor
TCTTTAGAGTCTAACA-1	Surrounding tumor
TCTTTAGCAGGCGAAC-1	Tumor
TCTTTCTCTTAAGGAG-1	Tumor
TGAAACTTATGCAAGC-1	Tumor
TGAAAGGACCTGACTC-1	Invasive
TGAACAAGCAGGGACT-1	Invasive
TGAATACCGACGCGTA-1	Invasive
TGAATATGCTATAAAC-1	Healthy
TGAATGAGTGTTTCCC-1	Invasive
TGAATGTCAGCCGGCC-1	Surrounding tumor
TGACACTTCTCTTTGC-1	Healthy
TGACATCGAGCGGACC-1	Tumor
TGACATGTAACGTGAC-1	Surrounding tumor
TGACCAAATCTTAAAC-1	Surrounding tumor
TGACCAGCTTCAAAGT-1	Healthy
TGACCCACGTTAGACA-1	Invasive
TGACGAATATTTCCCT-1	Surrounding tumor
TGACGATGCACTAGAA-1	Surrounding tumor
TGACTATAATCCTTTC-1	Healthy
TGACTCCGAATCATAC-1	Invasive
TGAGAATGCTTTACCG-1	Invasive
TGAGAGATTTACCACG-1	Invasive
TGAGATCAAATACTCA-1	Tumor
TGAGATTAGGCCCTAA-1	Healthy
TGAGCAGTCGTGAAGT-1	Surrounding tumor
TGAGCCATACAGTCTC-1	Invasive
TGAGCGGAAAGTGTTC-1	Tumor
TGAGCTTTAATGACGC-1	Surrounding tumor
TGAGGAGTGCCAGCTT-1	Tumor
TGAGGTGTGTGGCGGA-1	Invasive
TGAGTAAATTAGCGTA-1	Healthy
TGAGTGCCTCTTAAAT-1	Invasive
TGAGTGGTCCGTGACG-1	Invasive
TGAGTGTAACAACGGG-1	Invasive
TGAGTTAAAGACATTC-1	Surrounding tumor
TGATAGCGGGATTCTA-1	Surrounding tumor
TGATCACCACACTGAC-1	Invasive
TGATCAGGGAACTGCT-1	Surrounding tumor
TGATCCCAGCATTAGT-1	Surrounding tumor
TGATCGGTTTGACCCT-1	Invasive
TGATCTACGCTGATCT-1	Healthy
TGATCTATCACACTCT-1	Invasive
TGATCTCCGGCGCCAG-1	Invasive
TGATGGCTGTTTCTGA-1	Surrounding tumor
TGATGTCAATTAAGTG-1	Surrounding tumor
TGATTATGGCACGCAG-1	Healthy
TGATTCCCGGTTACCT-1	Invasive
TGATTCGTCTATCACT-1	Invasive
TGATTCTGTCGCCGGT-1	Invasive
TGATTTATTAGCTGTG-1	Invasive
TGATTTCCTCCTGACG-1	Invasive
TGCAAAGTTCGTCTGT-1	Invasive
TGCAACCCATCTGCGG-1	Invasive
TGCAACTACTGGTTGA-1	Invasive
TGCAAGAATGACGTAA-1	Invasive
TGCAATCTAACACGGT-1	Invasive
TGCAATTTGGGCACGG-1	Healthy
TGCACAGTGAAGTTAT-1	Healthy
TGCACGAGTCGGCAGC-1	Tumor
TGCAGAACTATATCGT-1	Surrounding tumor
TGCAGAGTACCGAGCA-1	Invasive
TGCAGATCGTCCTAGG-1	Surrounding tumor
TGCAGCTACGTACTTC-1	Surrounding tumor
TGCAGGATCGGCAAAG-1	Invasive
TGCAGTGAGGCTCGGG-1	Healthy
TGCAGTGGTAGGGAAC-1	Invasive
TGCAGTTTCCTCCCAT-1	Invasive
TGCATATGTCTGTCAC-1	Healthy
TGCATGGATCGGATCT-1	Invasive
TGCATGTGACCCATAG-1	Invasive
TGCATGTGGTAATCTA-1	Invasive
TGCCAAAGTCAGACTT-1	Surrounding tumor
TGCCACCTGGCGAAAC-1	Surrounding tumor
TGCCAGTACGTGGAGA-1	Healthy
TGCCATTACTAAAGAA-1	Surrounding tumor
TGCCCGATAGTTAGAA-1	Invasive
TGCCGAAAGCGTATTC-1	Tumor
TGCCGGATGTACGAGC-1	Invasive
TGCCGTGGATCGTCCT-1	Tumor
TGCCGTGGGACCCAAT-1	Surrounding tumor
TGCCTAATTGAAGATT-1	Surrounding tumor
TGCCTGACATCGGTCA-1	Invasive
TGCCTGATCAAACGAT-1	Invasive
TGCCTTGGCCAGGCAA-1	Surrounding tumor
TGCGAATATGGGATTT-1	Surrounding tumor
TGCGACACCCTAGTGC-1	Invasive
TGCGACGGCCGAACGT-1	Invasive
TGCGAGAATATTACCC-1	Surrounding tumor
TGCGAGATGGCGGCCA-1	Healthy
TGCGAGCCCTTCCGCG-1	Healthy
TGCGCAAAGCATTTGG-1	Invasive
TGCGCGATTAACGGAG-1	Invasive
TGCGGACTTGACTCCG-1	Invasive
TGCGGAGTAAAGGTGC-1	Invasive
TGCGGCATAGTTCAAC-1	Invasive
TGCGGGTATTGGGATC-1	Tumor
TGCGGTGAAATTTCAT-1	Surrounding tumor
TGCGTAAGAACCTGAT-1	Invasive
TGCGTACGGCTAATTG-1	Invasive
TGCGTCATGACTGAGC-1	Invasive
TGCGTGATTGGGTGTC-1	Invasive
TGCGTTTGTTGACACT-1	Invasive
TGCTAAGTGTCTATTT-1	Invasive
TGCTATACAAACGGAC-1	Tumor
TGCTATGGCAAAGGGA-1	Invasive
TGCTCCACAGTTCTTA-1	Surrounding tumor
TGCTCGGCGAAACCCA-1	Tumor
TGCTCGGTGGGTCACC-1	Invasive
TGCTCTTGAGAGTTTG-1	Surrounding tumor
TGCTGGTTGGACAATT-1	Invasive
TGCTGTTGAAGAACTC-1	Invasive
TGCTTAGAGAGAATGC-1	Invasive
TGCTTCCCAAGCAGTA-1	Tumor
TGCTTGAAACCATGCA-1	Invasive
TGGAAACGGAGTGAAC-1	Invasive
TGGAACCACTGACACA-1	Healthy
TGGAAGAAGGGAACGT-1	Invasive
TGGAAGACGAACACCA-1	Invasive
TGGAAGGATAAAGATG-1	Invasive
TGGAATATCCTTGACC-1	Healthy
TGGAATTAGACGCTTT-1	Surrounding tumor
TGGACCAATCTAAGAT-1	Tumor
TGGACCACGGCGTTGA-1	Invasive
TGGACGCAATCCAGCC-1	Invasive
TGGACTGTTCGCTCAA-1	Invasive
TGGAGAATAATCGTCC-1	Invasive
TGGAGCTAAAGTTCCC-1	Tumor
TGGAGGGAAACACCTC-1	Healthy
TGGAGTGATGCGATGA-1	Invasive
TGGATAGAGTAACAGA-1	Invasive
TGGCAAACTAAATTAC-1	Healthy
TGGCAACTCGCGCGCC-1	Surrounding tumor
TGGCAAGCACAAGTCG-1	Invasive
TGGCAATGGGACGGCG-1	Surrounding tumor
TGGCACGAGCTCGAGT-1	Healthy
TGGCAGATTACGATCA-1	Invasive
TGGCAGCAGTAATAGT-1	Invasive
TGGCATGAAGTTTGGG-1	Invasive
TGGCCAAACTGAAGTA-1	Invasive
TGGCCAATTTGGTACT-1	Invasive
TGGCCGTATATTGACC-1	Invasive
TGGCGGTGTGCGATTG-1	Invasive
TGGCTACACTCTACCT-1	Invasive
TGGCTATGTGACATAC-1	Tumor
TGGCTCTTGTCGCGTA-1	Surrounding tumor
TGGCTTGTACAAGCTT-1	Healthy
TGGCTTTGGGTAGACA-1	Invasive
TGGGAAATGCCTTTCC-1	Invasive
TGGGATGCACTCATTC-1	Healthy
TGGGCAATAGTTGGGT-1	Surrounding tumor
TGGGCACAAACAGAAC-1	Invasive
TGGGCACGTTCTATGG-1	Surrounding tumor
TGGGCAGGCCACCGCA-1	Surrounding tumor
TGGGCCACAAGAGCGC-1	Invasive
TGGGCCCATACTAATT-1	Surrounding tumor
TGGGCGATACAATAAG-1	Surrounding tumor
TGGGTAAGGTTCCCGC-1	Surrounding tumor
TGGGTGCACAAGCCAT-1	Invasive
TGGGTGGGATGTCATT-1	Healthy
TGGGTGTAATAGATTT-1	Invasive
TGGGTGTTAAGTAGAA-1	Surrounding tumor
TGGGTTTCGGGCGTAC-1	Invasive
TGGTAAGCAGGATTGA-1	Surrounding tumor
TGGTAGAATATATGGG-1	Surrounding tumor
TGGTATCGCATCCCAA-1	Tumor
TGGTATCGGTCTGTAT-1	Tumor
TGGTCCCACGCTACGG-1	Tumor
TGGTCTGTTGGGCGTA-1	Invasive
TGGTGATCGTATTTGT-1	Surrounding tumor
TGGTGCCCTGCCTTAC-1	Invasive
TGGTTAAGGGCGCTGG-1	Healthy
TGGTTCAACGGGTAAT-1	Healthy
TGGTTCGTAGCAAAGG-1	Invasive
TGGTTGGAGGATCCTG-1	Surrounding tumor
TGGTTTAAACGTGGGT-1	Healthy
TGTACCCGACCCTAAT-1	Invasive
TGTACCTACACGAGGG-1	Invasive
TGTACGAACAAATCCG-1	Invasive
TGTACTACTCTCACGG-1	Healthy
TGTACTTCCGGGCATG-1	Invasive
TGTAGCCAATTCCGTT-1	Invasive
TGTAGCCATCCCATTC-1	Surrounding tumor
TGTAGGAGAAATTTCC-1	Healthy
TGTAGTGATCTATAAT-1	Invasive
TGTATAACAGATCCTG-1	Invasive
TGTATCAGACTGAAGC-1	Healthy
TGTATCCTTATTCCAT-1	Invasive
TGTATGGCGCAGACAG-1	Surrounding tumor
TGTATTTACCTAATGC-1	Healthy
TGTCATTTGTTGGGAA-1	Healthy
TGTCCACGGCTCAACT-1	Invasive
TGTCCCGACATAGCAC-1	Invasive
TGTCCGCAAACAATTC-1	Invasive
TGTCCGTGGCGCCTTT-1	Surrounding tumor
TGTCCTAAGTCACCGC-1	Invasive
TGTCGGCATGGTGGAA-1	Invasive
TGTCGTGGGTATAGGC-1	Invasive
TGTCGTTATCACATAT-1	Invasive
TGTCTACAGTTTCTGT-1	Invasive
TGTGACTACGCCAGTC-1	Invasive
TGTGACTAGAGTTTGC-1	Invasive
TGTGAGACTAGCCCAA-1	Tumor
TGTGCCGGTGCCGGAA-1	Invasive
TGTGCTTTACGTAAGA-1	Surrounding tumor
TGTGGAGGAAGCTTAA-1	Tumor
TGTGGCAAAGCGTATG-1	Invasive
TGTGGCGGGCTTCTGG-1	Tumor
TGTGGCTCCCACCAAC-1	Surrounding tumor
TGTGGTTGCTAAAGCT-1	Invasive
TGTGTAGTAGCACGTG-1	Tumor
TGTGTCGCGAGTTGCA-1	Invasive
TGTGTTCGTATCCAAG-1	Invasive
TGTTATTGTATGTGGC-1	Invasive
TGTTCCGCTTCCATGA-1	Invasive
TGTTCCGGCCTGAGCT-1	Invasive
TGTTCTCTACTCCCTA-1	Healthy
TGTTCTTCCATTGACT-1	Invasive
TGTTGTCAAGAAGTCT-1	Surrounding tumor
TGTTTAATACTTCATC-1	Tumor
TGTTTCGGTACTTCTC-1	Invasive
TGTTTGAGATCGTCAG-1	Surrounding tumor
TTAAACAGAGTCCCGC-1	Invasive
TTAAACCGGTAGCGAC-1	Invasive
TTAAACCTGGTTCCTT-1	Surrounding tumor
TTAAACTCGAATTCAT-1	Healthy
TTAAAGGCGATGCTCG-1	Invasive
TTAAAGTAAGTCGCCA-1	Invasive
TTAACACCTCGAACAT-1	Surrounding tumor
TTAACCAACCCTCCCT-1	Invasive
TTAACGAACAAGCAGT-1	Healthy
TTAACGTCGCAAGACC-1	Invasive
TTAACTCACGCGTGGA-1	Surrounding tumor
TTAACTTCAGGTAGGA-1	Surrounding tumor
TTAAGACGAACGAACC-1	Healthy
TTAAGATAGGATTGAC-1	Tumor
TTAAGCCGACAACTTC-1	Surrounding tumor
TTAAGCGCCTGACCCA-1	Invasive
TTAAGGATACGGAGGT-1	Invasive
TTAAGGCCCGTACTTT-1	Invasive
TTAAGTATTGTTATCC-1	Invasive
TTAATCAGTACGTCAG-1	Surrounding tumor
TTAATGCGAGGTAACT-1	Tumor
TTAATGTAGACCAGGT-1	Invasive
TTAATTGCTTTGGGTG-1	Tumor
TTAATTTCAGACGCGG-1	Surrounding tumor
TTACAACTACGCATCC-1	Invasive
TTACACGATCTGCGAC-1	Surrounding tumor
TTACAGACCTAAATGA-1	Healthy
TTACATCGTGGCCTGG-1	Invasive
TTACATGCCACAACTA-1	Tumor
TTACCATTGATTACCC-1	Invasive
TTACCCATTGCCGGGT-1	Surrounding tumor
TTACCCTAACAGTCCT-1	Surrounding tumor
TTACCCTAGGGATTGG-1	Tumor
TTACCGCCTTAGGGAA-1	Invasive
TTACGGATGGTTCGAG-1	Healthy
TTACGGTGTCACCGAG-1	Surrounding tumor
TTACGTATCTATGACA-1	Surrounding tumor
TTACTAAAGGACTTTA-1	Healthy
TTACTCCGGCCGGGAA-1	Invasive
TTACTCTGGTACGTAC-1	Invasive
TTACTGGGATATTTCA-1	Invasive
TTACTGTCTAGAGCTC-1	Healthy
TTACTGTTTCTCTACG-1	Tumor
TTAGAAGAACATGACT-1	Healthy
TTAGAATAAGGGTCGG-1	Invasive
TTAGACACGATCGTTG-1	Surrounding tumor
TTAGACGAGTCACCTC-1	Healthy
TTAGAGTTTAGAAGGA-1	Surrounding tumor
TTAGATAGGTCGATAC-1	Invasive
TTAGCAACATGGATGT-1	Invasive
TTAGCTAATACGATCT-1	Healthy
TTAGCTGATTTGCCGT-1	Invasive
TTAGGTCATAACCGAC-1	Invasive
TTAGTAAACCTGCTCT-1	Invasive
TTAGTAGGGCGGCGGG-1	Invasive
TTAGTTATTCGTGGCA-1	Surrounding tumor
TTAGTTCAAGTGTTCG-1	Healthy
TTATAGATGCACATTA-1	Surrounding tumor
TTATAGGTAATTGTCT-1	Tumor
TTATAGTCCAAGGTGC-1	Healthy
TTATATACGCTGTCAC-1	Invasive
TTATATTTGGCAATCC-1	Invasive
TTATCCAATCGAACTC-1	Invasive
TTATCCGGGATCTATA-1	Invasive
TTATCCTCAAGGAATA-1	Invasive
TTATCGCCTGCGAAGC-1	Surrounding tumor
TTATCTGTATCATAAC-1	Invasive
TTATGAATGAAAGGGA-1	Invasive
TTATGACAAACTGGAT-1	Surrounding tumor
TTATGATCTTAACGAA-1	Surrounding tumor
TTATGCGTCCCGGTCC-1	Invasive
TTATGTTTGCGATAGA-1	Surrounding tumor
TTATTAGGGAAGCATC-1	Invasive
TTCAAAGTCTCTAGCC-1	Invasive
TTCAACGACCCGACCG-1	Invasive
TTCAAGCCGAGCTGAG-1	Surrounding tumor
TTCAATTAGCCATAAT-1	Tumor
TTCACGAAAGGATCAC-1	Invasive
TTCACTCGAGCACCTA-1	Tumor
TTCACTTCCTAGAACG-1	Invasive
TTCAGAGTAACCTGAC-1	Invasive
TTCAGCCCTGGTCCAC-1	Surrounding tumor
TTCAGCTGGCGTGCCC-1	Invasive
TTCAGGCGTCAAAGCC-1	Surrounding tumor
TTCAGTTCAAGAGGAG-1	Invasive
TTCATAGCCTTGTAAC-1	Invasive
TTCATGGCGCAACAGG-1	Surrounding tumor
TTCCAATCAGAGCTAG-1	Healthy
TTCCAATCTGGCTATC-1	Invasive
TTCCAGACGAGATTTA-1	Tumor
TTCCATCATGCGGTGA-1	Healthy
TTCCATCGACAGCGTG-1	Surrounding tumor
TTCCCGGCGCCAATAG-1	Invasive
TTCCGCAGAGAAATAT-1	Healthy
TTCCGCGTGAGGCGAT-1	Healthy
TTCCGGCTCGACTTCT-1	Healthy
TTCCGGTATCTGTGTC-1	Tumor
TTCCGGTTACCCACTT-1	Invasive
TTCCTCGAGGGTGTCT-1	Invasive
TTCCTCGGACTAACCA-1	Surrounding tumor
TTCCTTTCTGTGTTGC-1	Invasive
TTCGACAGAGCCCGTG-1	Healthy
TTCGACGGGAAGGGCG-1	Invasive
TTCGAGCCGGCGCTAC-1	Healthy
TTCGCACTCGCGTGCT-1	Invasive
TTCGCACTGTACGACA-1	Tumor
TTCGCATCCGGAAGCA-1	Invasive
TTCGCGCGCCATACGA-1	Invasive
TTCGCTAGGAAGTTGT-1	Surrounding tumor
TTCGCTATCTGACGTG-1	Healthy
TTCGGACTGATGCCTT-1	Healthy
TTCGGCAACCCGCTGA-1	Surrounding tumor
TTCGGCTAGAGATGGT-1	Invasive
TTCGGGACTAATCGCG-1	Invasive
TTCGGGTTGCCACGGG-1	Tumor
TTCGGTACTGTAGAGG-1	Surrounding tumor
TTCGTAATCCCAGCGG-1	Surrounding tumor
TTCGTACTCCAGAACG-1	Invasive
TTCGTTCAACGAAGTT-1	Healthy
TTCTAACCGAAGCTTA-1	Healthy
TTCTACCTCAATCGGT-1	Invasive
TTCTACCTTTATGTTG-1	Surrounding tumor
TTCTACTTGCGAGGGC-1	Invasive
TTCTAGAAAGTCTTAT-1	Invasive
TTCTAGGCCAATTGTG-1	Invasive
TTCTATGCCTTTCGCA-1	Surrounding tumor
TTCTATTAAACGCAGC-1	Invasive
TTCTCAATTGCTACAA-1	Invasive
TTCTGACCGGGCTCAA-1	Invasive
TTCTGCCGCGCCTAGA-1	Healthy
TTCTGCGGGTTAGCGG-1	Invasive
TTCTGCTAGACTCCAA-1	Surrounding tumor
TTCTTAGTGAACGGTG-1	Invasive
TTCTTAGTGGCTCAGA-1	Invasive
TTCTTATCCGCTGGGT-1	Surrounding tumor
TTCTTCCCTTTGATAT-1	Tumor
TTCTTGAGCCGCGCTA-1	Invasive
TTCTTGCTAGCATCTC-1	Tumor
TTCTTGGACGATCTGC-1	Surrounding tumor
TTCTTGGAGTAATGAG-1	Surrounding tumor
TTCTTGTAACCTAATG-1	Invasive
TTCTTTGGTCGCGACG-1	Healthy
TTGAAAGGTGTAAAGG-1	Healthy
TTGAACGAATCCTTTG-1	Invasive
TTGAACGACGTGCTGA-1	Invasive
TTGAAGAATTCCCAGG-1	Invasive
TTGAAGGATGGGCGCC-1	Invasive
TTGAATATGGACTTTC-1	Invasive
TTGAATCGTTGTATAA-1	Invasive
TTGAATTCACGTGAGG-1	Tumor
TTGACAGGAGCTCCCG-1	Surrounding tumor
TTGACATGAACGTGGA-1	Invasive
TTGACCAGGAACAACT-1	Invasive
TTGACCATGTTCTCCG-1	Surrounding tumor
TTGACCGTGTTAATGA-1	Surrounding tumor
TTGACGATTCAGCACG-1	Invasive
TTGACGCTCCATGAGC-1	Tumor
TTGACTACCATATGGT-1	Invasive
TTGACTATTGTCCGGC-1	Surrounding tumor
TTGAGAAGTTTAGCAT-1	Invasive
TTGAGAGTACTGCTAA-1	Invasive
TTGAGCAGCCCACGGT-1	Surrounding tumor
TTGAGCGCCACGTGAT-1	Tumor
TTGAGGCATTTAACTC-1	Healthy
TTGAGTCCCGCTGCTG-1	Tumor
TTGATAGTCAATACAT-1	Surrounding tumor
TTGATCTAACTTTGTC-1	Invasive
TTGATGCCGCTCGTCG-1	Invasive
TTGATGTGTAGTCCCG-1	Healthy
TTGATTAGCTGTTTCT-1	Invasive
TTGATTATGCAGATGA-1	Surrounding tumor
TTGCAAGAAGACTCCT-1	Invasive
TTGCACAATTCAGAAA-1	Invasive
TTGCACGGAGCAGCAC-1	Invasive
TTGCATGCTGATCACG-1	Invasive
TTGCCAAGCAGAACCC-1	Surrounding tumor
TTGCCATAGCCCGCTC-1	Surrounding tumor
TTGCCCTGATCACGGG-1	Invasive
TTGCCGCAGACCTACA-1	Invasive
TTGCCGCTTTCTAGTA-1	Tumor
TTGCCGGTGATCCCTC-1	Healthy
TTGCCTAATCCAAAGT-1	Invasive
TTGCCTTCTCGCCGGG-1	Invasive
TTGCGCACAACCACGT-1	Surrounding tumor
TTGCGCTTGATCAATA-1	Invasive
TTGCGGCGACTCATGC-1	Tumor
TTGCGTAGTTTGAGGA-1	Surrounding tumor
TTGCGTGAACGCTTAG-1	Healthy
TTGCGTGTGTAGGCAT-1	Invasive
TTGCTCATAGTACGTG-1	Invasive
TTGCTCCCATACCGGA-1	Invasive
TTGCTGAAGGAACCAC-1	Invasive
TTGCTGATCATGTTCG-1	Surrounding tumor
TTGCTGCACCTATCCA-1	Surrounding tumor
TTGCTGGCCGGGCTTC-1	Tumor
TTGGAAGAATACAGTC-1	Surrounding tumor
TTGGACATGTGGCTTA-1	Invasive
TTGGACCATCTGGCAA-1	Surrounding tumor
TTGGACCTATAACAGT-1	Invasive
TTGGAGTCTCCCTTCT-1	Invasive
TTGGATATCGTCTACG-1	Invasive
TTGGATCGACTTCTGG-1	Surrounding tumor
TTGGATTGGGTACCAC-1	Invasive
TTGGCCAAATTGTATC-1	Invasive
TTGGCCATCTTGCGCT-1	Invasive
TTGGCCTAGAATTTCG-1	Surrounding tumor
TTGGCGATCCGAATAT-1	Tumor
TTGGCTCAATATGTGT-1	Surrounding tumor
TTGGCTCGCATGAGAC-1	Invasive
TTGGGAAGACGAGCCG-1	Surrounding tumor
TTGGGACACTGCCCGC-1	Invasive
TTGGGACGTAAGAGTT-1	Surrounding tumor
TTGGGCGGCGGTTGCC-1	Invasive
TTGGTATGGCTTGTGT-1	Tumor
TTGGTCACACTCGTAA-1	Invasive
TTGGTTGCGGTGCGCG-1	Surrounding tumor
TTGTAAGGACCTAAGT-1	Invasive
TTGTAAGGCCAGTTGG-1	Invasive
TTGTAATCCGTACTCG-1	Invasive
TTGTATCACACAGAAT-1	Surrounding tumor
TTGTCGTTCAGTTACC-1	Invasive
TTGTGAACCTAATCCG-1	Invasive
TTGTGAGGCATGACGC-1	Surrounding tumor
TTGTGATCTGTTCAGT-1	Invasive
TTGTGCAGCCACGTCA-1	Tumor
TTGTGGCCCTGACAGT-1	Invasive
TTGTGGTAGGAGGGAT-1	Surrounding tumor
TTGTGGTGGTACTAAG-1	Invasive
TTGTGTATGCCACCAA-1	Tumor
TTGTTAGCAAATTCGA-1	Invasive
TTGTTCAGTGTGCTAC-1	Invasive
TTGTTGTGTGTCAAGA-1	Invasive
TTGTTTCACATCCAGG-1	Invasive
TTGTTTCATTAGTCTA-1	Invasive
TTGTTTCCATACAACT-1	Surrounding tumor
TTGTTTGTGTAAATTC-1	Surrounding tumor
