AAACAAGTATCTCCCA-1	Pal::GPi
AAACACCAATAACTGC-1	MOB::Gl_1
AAACAGAGCGACTCCT-1	SS::L2/3
AAACAGCTTTCAGAAG-1	MOB::Gr
AAACAGGGTCTATATT-1	MOB::Gr
AAACATGGTGAGAGGA-1	MOB::Gl_1
AAACATTTCCCGGATT-1	Pal::MA
AAACCGGGTAGGTACC-1	ORB::L2/3
AAACCGTTCGTCCAGG-1	AOE
AAACCTAAGCAGCCGG-1	OT::PoL
AAACGAAGATGGAGTA-1	MOB::Gl_1
AAACGAGACGGTTGAT-1	CPu
AAACGGGCGTACGGGT-1	Pal::MA
AAACGGTTGCGAACTG-1	AON::L1_1
AAACTCGGTTCGCAAT-1	OT::PoL
AAACTCGTGATATAAG-1	CC
AAACTGCTGGCTCCAA-1	CPu
AAACTTAATTGCACGC-1	MOB::Gl_1
AAACTTGCAAACGTAT-1	AOB::Gr
AAAGAATGTGGACTAA-1	Pal::NDB
AAAGGCTACGGACCAT-1	AON::L2
AAAGGCTCTCGCGCCG-1	PIR
AAAGGGATGTAGCAAG-1	MO::L5
AAAGTAGCATTGCTCA-1	AOB::Gr
AAAGTGTGATTTATCT-1	CPu
AAAGTTGACTCCCGTA-1	St
AAATAACCATACGGGA-1	SS::L1
AAATAAGGTAGTGCCC-1	SLu
AAATACCTATAAGCAT-1	CPu
AAATAGCTTAGACTTT-1	Fim
AAATAGGGTGCTATTG-1	AcbC
AAATCCGATACACGCC-1	Pal::MA
AAATCGCGGAAGGAGT-1	MOB::Opl
AAATCGTGTACCACAA-1	Cl
AAATCTAGCCCTGCTA-1	Pal::Sl
AAATGATTCGATCAGC-1	SS::L6
AAATGGCCCGTGCCCT-1	MOB::Gr
AAATGGTCAATGTGCC-1	MO::L5
AAATTAACGGGTAGCT-1	MO::L5
AAATTACACGACTCTG-1	SS::L1
AAATTACCTATCGATG-1	SS::L6
AAATTCCAGGTCCAAA-1	Fim
AAATTGATAGTCCTTT-1	Ft
AAATTTGCGGGTGTGG-1	ORB::L2/3
AACAACTGGTAGTTGC-1	MO::L2/3
AACACACGCTCGCCGC-1	Pal::GPi
AACACGAGACGCGGCC-1	AOB::Gl
AACAGCTGTGTGGCAA-1	MOB::lpl
AACAGGATGGGCCGCG-1	MO::L1
AACAGGTAGTATGGAT-1	TH::RT
AACATATCAACTGGTG-1	SS::L6
AACATCGATACGTCTA-1	SS::L5
AACATTGTGACTCGAG-1	Io
AACCAAGACTTCTCTG-1	FRP::L1
AACCCATCCCATGATC-1	MOB::Opl
AACCCGAGCAGAATCG-1	HY::LPO
AACCCTACTGTCAATA-1	CPu
AACCGAGCTTGGTCAT-1	MO::L5
AACCGCTAAGGGATGC-1	CPu
AACCTCGCTTTAGCCC-1	AcbSh
AACCTTTAAATACGGT-1	AcbC
AACCTTTACGACGTCT-1	SS::L2/3
AACGAAAGTCGTCCCA-1	MOB::Opl
AACGATAATGCCGTAG-1	AcbC
AACGATATGTCAACTG-1	MO::L5
AACGCATGATCTGGGT-1	SS::L5
AACGCGGTCTCCAGCC-1	MO::L2/3
AACGCTGTTGCTGAAA-1	Pal::Sl
AACGGACGTACGTATA-1	CPu
AACGGCCATCTCCGGT-1	ORB::L2/3
AACGTACTGTGGGTAC-1	ORB::L5
AACGTCAGACTAGTGG-1	MO::L1
AACGTCGCTGCACTTC-1	OT::Ml
AACGTGCGAAAGTCTC-1	CPu
AACTACCCGTTTGTCA-1	TH::RT
AACTAGGCTTGGGTGT-1	AcbC
AACTCAAGTTAATTGC-1	MO::L5
AACTCCAGAGCGTGTT-1	Pal::Sl
AACTCCTAATCCCATG-1	SS::L1
AACTCTCAATAGAGCG-1	CPu
AACTCTCAGTGTGCTC-1	AOE
AACTGGGTCCCGACGT-1	MO::L2/3
AACTTGCCCGTATGCA-1	MO::L1
AAGACATACGTGGTTT-1	Pal::NDB
AAGACCAAATAACTCA-1	MOB::Gl_1
AAGACCCAACTGAACA-1	AON::L2
AAGACTGCAAGCTACT-1	CC
AAGAGCTCTTTATCGG-1	CPu
AAGAGGATGTACGCGA-1	FRP::L2/3
AAGAGGCATGGATCGC-1	CPu
AAGAGGCCCTTTGGAA-1	HY::LPO
AAGATGGCACCGGACC-1	AOE
AAGATTGGCGGAACGT-1	SS::L5
AAGCACCCTGCGTATC-1	AcbC
AAGCATACTCTCCTGA-1	AcbC
AAGCCGAAGCGGTTTA-1	TH::RT
AAGCGCAGGGCTTTGA-1	OT::PoL
AAGCGTCCCTCATCGA-1	Ft
AAGCTAGATCGAGTAA-1	CPu
AAGCTCGTGCCAAGTC-1	CPu
AAGCTCTTTCATGGTG-1	AcbC
AAGGAGCGGTTGGTGC-1	MO::L2/3
AAGGATCGATCGCTTG-1	Fim
AAGGATGAGGGACCTC-1	MO::L6
AAGGCGCGTAAAGCTT-1	MO::L1
AAGGCTGTGCTCATCG-1	MO::L2/3
AAGGGAACGACTGGCT-1	MOB::Gl_1
AAGGGACAGATTCTGT-1	SS::L6
AAGGGACTATGCATTC-1	MOB::Opl
AAGGGTTTGATTTCAG-1	MOB::Gl_1
AAGGTATCCTAATATA-1	MO::L5
AAGGTGATAAACCAGC-1	CPu
AAGTAGTGACGCGAGG-1	MO::L2/3
AAGTCAATTGTCGTCA-1	St
AAGTCTTCTGTGGCCT-1	MOB::Gl_2
AAGTGACGACCGAATT-1	ORB::L2/3
AAGTGAGTCGGGTTTA-1	AON::L1_1
AAGTGCCTTGACTGTA-1	St
AAGTGCGTTAGAATCT-1	AOB::Ml
AAGTGTTTGGAGACGG-1	CPu
AAGTTCACTCCAAGCT-1	AcbC
AAGTTCAGTCTGCGTA-1	SS::L5
AAGTTCGGCCAACAGG-1	ORB::L2/3
AAGTTGTGATGTTATA-1	Pal::NDB
AAGTTTATGGGCCCAA-1	OT::PoL
AATAACAACGCTCGGC-1	MO::L2/3
AATAACACTAGAACAA-1	AOE
AATACCTGATGTGAAC-1	OT::Ml
AATAGAACAGAGTGGC-1	ORB::L1
AATAGAATCTGTTTCA-1	CPu
AATAGCTACCGCGTGC-1	SS::L5
AATAGTCCGTCCCGAC-1	En
AATATCCTAGCAAACT-1	MOB::Gr
AATATCGAATCAATGC-1	TH::RT
AATATCGAGGGTTCTC-1	CC
AATATTGGAGTATTGA-1	FRP::L1
AATCATGTAAAGACTC-1	Pal::Sl
AATCGCCTCAGCGCCA-1	CPu
AATCGCGCAGAGGACT-1	TH::RT
AATCGGTATAGCCCTC-1	Pal::NDB
AATCGTGAGCCGAGCA-1	OT::PoL
AATCTAGGTTTACTTG-1	MOB::Gr
AATCTATGCCGGAGCC-1	Or
AATCTCTACTGTGGTT-1	MOB::Gl_2
AATCTGCGTTGGGACG-1	CPu
AATCTGGCTTTCTAGT-1	MOB::Gr
AATGACAGCAATGTCT-1	ORB::L1
AATGACGTAGGATGTC-1	CPu
AATGACTGTCAGCCGG-1	MO::L2/3
AATGATGATACGCTAT-1	SS::L5
AATGATGCGACTCCTG-1	SS::L6
AATGCAACCGGGTACC-1	MO::L5
AATGCACCAAGCAATG-1	SS::L5
AATGTGCCCGAGGTGT-1	MOB::Gr
AATGTTGTCGTGAGAC-1	Pal::NDB
AATTAAAGGTCGGCGT-1	MO::L6
AATTAACGGATTTCCA-1	AcbC
AATTACGAGACCCATC-1	MOB::Gl_1
AATTAGCGCTGCAGCG-1	Cl
AATTCATAAGGGATCT-1	SS::L5
AATTCATTGTCATGCA-1	MOB::Gl_1
AATTCCAAGCATGTAC-1	AON::L1_1
AATTCGATTCGAGGAT-1	OT::PoL
AATTCTAGAGTTAGGC-1	Cl
AATTGAACGCTCTGGT-1	CPu
AATTGCAGCAATCGAC-1	Pal::MA
AATTTGGGACATAGTA-1	SS::L1
ACAAACCATGCGTCCT-1	MOB::Gl_1
ACAAAGAAGGTAGGCC-1	MOB::Gr
ACAAAGCATGACCTAG-1	Pal::MA
ACAAATCGCACCGAAT-1	CPu
ACAAATGGTAGTGTTT-1	CPu
ACAACAGCATGAGCTA-1	MO::L6
ACAAGCAGTGCCTAGC-1	MO::L1
ACAAGGAAATCCGCCC-1	CPu
ACAAGGACAAGAGGTT-1	MO::L2/3
ACAAGGATGCTTTAGG-1	Pal::Sl
ACAAGGGCAGGCTCTG-1	CPu
ACAATAGTCGTACGTT-1	AOB::Gr
ACAATCCATTTAAACC-1	MO::L2/3
ACAATGAATACGGAGA-1	MOB::lpl
ACAATTGTGTCTCTTT-1	Pal::GPi
ACAATTTGAGCAGTGG-1	MO::L6
ACACAAAGACGGGTGG-1	MO::L2/3
ACACACCAGGACCAGT-1	CPu
ACACATGATCAAATCT-1	MOB::Gl_1
ACACCCAGCATGCAGC-1	MO::L2/3
ACACCTTAAGTAGGGC-1	MO::L2/3
ACACCTTACTACTTGC-1	TH::RT
ACACGAGACTCCTTCT-1	MO::L6
ACACGGGAACTTAGGG-1	MO::L5
ACACGTAGGCCACAAG-1	HY::LPO
ACACTGATCAAGGTGT-1	PIR
ACAGAACTGAGAACAA-1	MOB::Gr
ACAGCGACATTCTCAT-1	Pal::Sl
ACAGGCACGGATCCTT-1	Pal::NDB
ACAGGCTTGCCCGACT-1	AcbC
ACAGGTGGAGGTGAGG-1	ORB::L1
ACAGTAATACAACTTG-1	MOB::Gr
ACATAAGTCGTGGTGA-1	MOB::Gl_1
ACATAATAAGGCGGTG-1	MO::L2/3
ACATCCCGGCCATACG-1	En
ACATCCTGGTAACTGT-1	St
ACATCGATCGTTTACC-1	CPu
ACATCGGTCAGCCGCG-1	ORB::L5
ACATCGTATGCAATGG-1	CPu
ACATGGCGCCAAAGTA-1	St
ACATTAGTTTATATCC-1	Cl
ACATTTGAAACCTAAC-1	OT::Ml
ACCAAACACCCAGCGA-1	SS::L5
ACCAACACCACACACT-1	SS::L5
ACCAACCGCACTCCAC-1	Pal::MA
ACCAACGCTTATTTAT-1	PIR
ACCAAGTCATCGGCAG-1	Pal::NDB
ACCAATATGCAAGTTA-1	AcbC
ACCACAAGTTTCTATC-1	MO::L5
ACCACCAATGTAACAA-1	St
ACCACGTGCAGCTATA-1	CPu
ACCAGACCATAACAAC-1	MOB::Gl_2
ACCAGTGCGGGAGACG-1	Pal::GPi
ACCATATCCGCAATAA-1	MO::L6
ACCATCCGCCAACTAG-1	MOB::Gr
ACCATCGTATATGGTA-1	ORB::L6
ACCCAACGCCCGTGGC-1	CC
ACCCATCTTGAGGGTA-1	MO::L5
ACCCATTTGTCCCTCT-1	Pal::Sl
ACCCGGAAACTCCCAG-1	AcbC
ACCCGGATGACGCATC-1	CPu
ACCCGGTTACACTTCC-1	ORB::L6
ACCCGTGTCATCAGTA-1	AON::L1_2
ACCCTATGCCATATCG-1	AOE
ACCCTCCCGTCAGGGC-1	Pal::NDB
ACCCTCCCTTGCTATT-1	CPu
ACCCTGGTAACGCCCT-1	SS::L6
ACCGAAGAGTCTGGTT-1	MOB::Opl
ACCGACACATCTCCCA-1	AcbSh
ACCGACTGAGTCCCAC-1	MO::L5
ACCGAGTCTCCTTATT-1	OT::Pl
ACCGATGGTAGCATCG-1	CPu
ACCGCAATAACTGCCT-1	CPu
ACCGCGGTGGAAGTCG-1	St
ACCGGGCCTTTGTTGA-1	Pal::GPi
ACCGGTCAGGTACACC-1	MOB::Gl_1
ACCGTCCACTGGGCCC-1	MOB::Gl_1
ACCTAAGTACCTTTCA-1	Ft
ACCTAATCGACTTCCT-1	MO::L2/3
ACCTACAGTATGTGGT-1	TH::RT
ACCTACTATAAATCTA-1	Io
ACCTCCGCCCTCGCTG-1	Pal::Sl
ACCTCCGTTATTCACC-1	Or
ACCTGCGTGTCATGTT-1	AOB::Gr
ACGAAATGGGCGGCAC-1	MO::L1
ACGACTCTAGGGCCGA-1	OT::Ml
ACGAGGATACCACTCT-1	MOB::Gr
ACGAGGTTTACAACGT-1	MOB::Opl
ACGAGTACGGATGCCC-1	CC
ACGATACATAGAACTA-1	MO::L5
ACGATCATACATAGAG-1	MO::L5
ACGATCATCTTGTAAA-1	CPu
ACGATGCATATGTTAT-1	MO::L5
ACGCAAACTAATAGAT-1	Io
ACGCAATCACTACAGC-1	CC
ACGCATACGTTTACTA-1	Pal::Sl
ACGCATTCGTGAGTAC-1	MO::L5
ACGCCAGATGATTTCT-1	MO::L2/3
ACGCCAGTGCGTTTGC-1	OT::Pl
ACGCCGCTAGACGACC-1	CPu
ACGCGAAGTCAGACGA-1	Cl
ACGCGCTACACAGGGT-1	FRP::L2/3
ACGCGGGCCAAGGACA-1	MO::L6
ACGCTAGTGATACACT-1	CC
ACGCTGTGAGGCGTAG-1	MOB::Opl
ACGGAACACGAGTGCC-1	OT::Ml
ACGGACTCTCAAAGCG-1	AcbSh
ACGGAGCGCAAATTAC-1	SS::L5
ACGGATGGTGCGGATA-1	AcbC
ACGGCACTTGCTTGGG-1	PIR
ACGGCCAACATGGACT-1	PIR
ACGGCGACGATGGGAA-1	CPu
ACGGCTGGATGTAGAA-1	MOB::Gl_1
ACGGGAGTGTCGGCCC-1	AOB::Gl
ACGGTACAGTTCAATG-1	OT::Pl
ACGTAGATTGCTGATG-1	MO::L6
ACGTAGGAGAGTCGCT-1	OT::Pl
ACGTATTACTCCGATC-1	St
ACGTCTCGTTCCGGGA-1	MOB::Gr
ACGTGACAAAGTAAGT-1	MOB::Gr
ACGTGCGCCTCGTGCA-1	MO::L1
ACGTTAATGTCGAAGA-1	CPu
ACGTTAGATTTGCCCG-1	MO::L5
ACGTTCGCAATCAATT-1	Py
ACGTTCGTTCAGGAAA-1	AON::L1_1
ACGTTCTGTACAAGTC-1	Pal::MA
ACTACATCCCGACAAG-1	MOB::Gl_1
ACTACCAGCTCTCTGG-1	MO::L2/3
ACTACGCGTTAGAATT-1	AON::L1_2
ACTAGTTGCGATCGTC-1	TH::RT
ACTATATGCTGTGTTC-1	SS::L2/3
ACTATCCAGGGCATGG-1	Fim
ACTATCTGCCCGCGTA-1	TH::RT
ACTATTTCCGGGCCCA-1	AON::L1_1
ACTCAAGTGCAAGGCT-1	Pal::Sl
ACTCAATAAAGGCACG-1	MO::L5
ACTCCCATTCCTAAAG-1	AOB::Gr
ACTCCCGAATTCGTTT-1	LV
ACTCCCTAATGCTAAA-1	AcbC
ACTCCCTAGAATAGTA-1	CPu
ACTCCGGCCGACCACT-1	OT::Ml
ACTCGCCGTTCGATAA-1	Pal::NDB
ACTCGTAACCCGTCCT-1	AOB::Gr
ACTCGTCAGTAATCCC-1	CPu
ACTCTCTGACTTAGGT-1	CPu
ACTCTGACCTAATAGA-1	Pal::NDB
ACTCTTGTATAGTAAC-1	CPu
ACTGAAACGCCGTTAG-1	Pal::Sl
ACTGAATGGCGAAAGT-1	CPu
ACTGCCGTCGTAACTC-1	MO::L1
ACTGCTCGGAAGGATG-1	MOB::lpl
ACTGTACGATACACAT-1	MO::L6
ACTGTAGCACTTTGGA-1	MO::L2/3
ACTGTCCAGGATTATA-1	MO::L5
ACTGTCTTCTTTAGAA-1	MO::L5
ACTTACGCATCCACGC-1	AcbC
ACTTATACTTACCCGG-1	CPu
ACTTATTAGGATCGGT-1	MO::L6
ACTTATTTATGTGCCA-1	CPu
ACTTCAGGCTGATCCC-1	CPu
ACTTCCAGTGGAAGCT-1	MOB::Opl
ACTTCCATGCGGGACA-1	Pal::MA
ACTTCGCCATACGCAC-1	MO::L5
ACTTGACTCCCTCTTT-1	CPu
ACTTGGGACCCGGTGG-1	MO::L2/3
ACTTGTAGTCCCTTCA-1	MOB::Gr
ACTTGTGGATGGAACG-1	TH::RT
ACTTTACCCTCATGAA-1	LV
ACTTTCCTATAGCTTC-1	MO::L5
ACTTTGACTGCATCCT-1	MOB::Opl
ACTTTGGTCGTGCTCC-1	MOB::Gl_1
AGAACCCTCAATTGGG-1	MOB::Gl_1
AGAACGTGGTACATTC-1	MO::L5
AGAAGAGCGCCGTTCC-1	CPu
AGAAGGTACACTTCAC-1	MOB::Gr
AGAAGGTTGCCGAATT-1	ORB::L6
AGAAGGTTGTAGGTCG-1	AcbSh
AGAAGTGATTCGTGAT-1	AOB::Gl
AGAATGCGGGTTCGGA-1	SS::L1
AGAATTATGGATTCGA-1	CPu
AGACCAAACCACACCT-1	MOB::Gr
AGACCCACCGCTGATC-1	Cl
AGACCCGCCCTCCTCG-1	MO::L5
AGACCGCTCCGCGGTT-1	TH::RT
AGACCGGGAAACCCTG-1	MOB::Opl
AGACGAAGTGCCGGTC-1	Pal::GPi
AGACGACGATGCCGCT-1	Ft
AGACTAGCCTTCCAGA-1	MO::L2/3
AGAGAACCGTCTAGGA-1	SS::L5
AGAGAAGGAGTACAAT-1	Ft
AGAGATCTCTAAAGCG-1	MOB::Opl
AGAGCCGCCGAGATTT-1	HY::LPO
AGAGGCTTCGGAAACC-1	Pal::GPi
AGAGTAAACTTCACTA-1	TH::RT
AGATAACTTCAGGGCC-1	MO::L2/3
AGATACCAATAGAACC-1	Pal::MA
AGATACCGGTGTTCAC-1	ORB::L5
AGATACTCAAGATCGA-1	CPu
AGATATAATACGACTA-1	AcbSh
AGATCGTGCATAAGAT-1	SS::L5
AGATCTCAGGTGTGAT-1	MO::L6
AGATGACTCGCCCACG-1	MO::L2/3
AGATGAGGGTTGCGAT-1	SS::L2/3
AGATGATGGAGTCTGG-1	LV
AGATGCAAGACGTGCA-1	MOB::Opl
AGATGCATCCTGTGTC-1	MOB::Gr
AGATTATAGGACGTTT-1	MO::L5
AGATTCACAACCGATA-1	MOB::Gr
AGCAAAGGCCGCTAGT-1	AcbSh
AGCAACATATCTTATT-1	CPu
AGCAACCGAAAGTAAT-1	MOB::Opl
AGCACCAGTACTCACG-1	MO::L5
AGCACTACCTCACCAG-1	AcbC
AGCACTTAAGGACGCC-1	MO::L2/3
AGCAGAAGGAGAAAGA-1	AcbSh
AGCAGCCAGATGAATA-1	En
AGCATATCAATATGCT-1	Pal::GPi
AGCATCATTTCGAAAG-1	MOB::Gr
AGCATCGTCGATAATT-1	MO::L2/3
AGCATTACGAGGCAAG-1	Pal::NDB
AGCCAAGCTTTGTGTC-1	AON::L2
AGCCACAGGTTACCCG-1	Pal::MA
AGCCACTCCCGTGCTT-1	MO::L5
AGCCCATACATGTAAG-1	ORB::L2/3
AGCCCGCACTACAATG-1	OT::Ml
AGCCCGGTAGCCTGTA-1	AON::L1_1
AGCCCTTCTAATCCGA-1	SS::L5
AGCCGTGGCTAAATGT-1	MOB::Gr
AGCCTAATACCCACGT-1	MOB::Gr
AGCGACAGGAACGGTC-1	ORB::L1
AGCGACCAACGATATT-1	MO::L2/3
AGCGATGCGCCTAATA-1	Pal::MA
AGCGCATAATGAATCG-1	AON::L1_2
AGCGCGGGTGCCAATG-1	SS::L5
AGCGGACACTTCGTAG-1	En
AGCGGCGGTTAGCGGT-1	MOB::Gr
AGCGGGTCTGACACTC-1	AON::L2
AGCGTGGTATTCTACT-1	CPu
AGCTAAGTACGCAGGC-1	Pal::MA
AGCTAGAAGCAGAAGT-1	SS::L5
AGCTATTTAATCCAAC-1	MO::L1
AGCTCCATATATGTTC-1	HY::LPO
AGCTCCTTCGCACATC-1	AcbC
AGCTCTAGACGTTCCA-1	CPu
AGCTCTTCCCAGTGCA-1	SS::L2/3
AGCTCTTCGTAACCTT-1	Fim
AGCTCTTTACTCAGTT-1	ORB::L6
AGCTGAAGTAAACCAA-1	SS::L2/3
AGCTGTAACCTCAATC-1	MOB::Gr
AGCTTCTTCTCGAGCA-1	Pal::NDB
AGCTTGATCTTAACTT-1	ORB::L1
AGGAAGCTGTCCGCCG-1	AcbSh
AGGACAGTCGAATCCC-1	CPu
AGGACGACCCATTAGA-1	ORB::L6
AGGACGCTCGATGTTG-1	SS::L5
AGGAGGCCTTCGCGCG-1	Pal::GPi
AGGATAAAGTCGGGAT-1	AcbC
AGGATATAGGGATTTA-1	CPu
AGGATATCCGACTGCA-1	OT::Pl
AGGATCACGCGATCTG-1	MOB::Gr
AGGCAGATGCGTAAAC-1	MO::L5
AGGCAGGGAGCGTACT-1	AON::L2
AGGCATTGTCGTAGGG-1	Pal::GPi
AGGCCACCCGTTATGA-1	MO::L2/3
AGGCCCTAGAACGCCA-1	AOB::Gl
AGGCCTGAGAATCTCG-1	Pal::MA
AGGCGGTTTGTCCCGC-1	MOB::Gl_1
AGGCGTCTATGGACGG-1	SS::L5
AGGCTTCCCGAAGAAG-1	ORB::L2/3
AGGGAAACGAGGTACT-1	SS::L1
AGGGACCGGCTGCGTT-1	Fim
AGGGACTCTACGCGAC-1	PIR
AGGGAGACATACTTCG-1	SLu
AGGGCGAGCAGCTGAT-1	AOB::Gl
AGGGCTGCAGTTACAG-1	CC
AGGGTCAGTAACCCTA-1	SS::L2/3
AGGGTCGATGCGAACT-1	CPu
AGGGTGCTCTCGAGGG-1	CPu
AGGGTTCCCTTTGGTT-1	CC
AGGGTTTAGTTCGGGA-1	MO::L6
AGGTAGGTACAAAGCT-1	MO::L2/3
AGGTATAATTGATAGT-1	Fim
AGGTCAGGTGAGAGTG-1	AOB::Gr
AGGTCGCGGAGTTACT-1	CC
AGGTGCACGTCCACAT-1	Pal::NDB
AGGTGGTGACCTTCGC-1	AON::L1_1
AGGTTACACCATGCCG-1	TH::RT
AGGTTGAGGCACGCTT-1	MO::L5
AGGTTTCACACACCTT-1	CPu
AGTAACTATAGCAGCC-1	Pal::NDB
AGTACAGAAGCTTATA-1	OT::Ml
AGTACATCATTTATCA-1	Or
AGTACGGGCACCTGGC-1	MO::L5
AGTACTCTTATGCCCA-1	AcbC
AGTAGGAAGGAAGTTG-1	SS::L2/3
AGTATGCTGGAGACCA-1	MOB::Opl
AGTATTTGGCACGACC-1	AON::L1_2
AGTCAACACCACCATC-1	ORB::L6
AGTCAAGATGACACTT-1	CPu
AGTCACTAGCTCTCGA-1	Pal::Sl
AGTCCATTGGCTGATG-1	St
AGTCCCGCCTTTAATT-1	SS::L2/3
AGTCGACGGTCTCAAG-1	CPu
AGTCGGCCCAAACGAC-1	MO::L1
AGTCGGCTCAACTTTA-1	AOB::Gl
AGTCGGTTGCGTGAGA-1	Fim
AGTCGTATAAAGCAGA-1	OT::PoL
AGTCGTCGACCACCAA-1	Pal::Sl
AGTCGTGGGCATTACG-1	Ft
AGTCTAAAGTATACTC-1	Py
AGTCTCACAAGACTAC-1	AOB::Gr
AGTCTTCTCCTCAAAT-1	MO::L5
AGTCTTTAAAGTGTCC-1	OT::PoL
AGTGAACAAACTTCTC-1	St
AGTGACCTACTTTACG-1	Cl
AGTGAGACTTCCAGTA-1	CPu
AGTGAGCCTCGCCGCC-1	CC
AGTGAGTCGAATTAAC-1	Pal::NDB
AGTGATAACCTGCGCG-1	Pal::Sl
AGTGATATGAGTAGTT-1	ORB::L6
AGTGATTCAAGCAGGA-1	CPu
AGTGCACGCTTAAGAA-1	Pal::GPi
AGTGCGTAGCTCGTAA-1	ORB::L5
AGTGCTAAACACAGCA-1	Pal::Sl
AGTGCTTGCACGAATA-1	CPu
AGTGGCCCGCAAATGG-1	OT::Ml
AGTGGCGGCAATTTGA-1	SS::L5
AGTGGCGTCTGAAGGT-1	Pal::MA
AGTGGCTCCGTCGGCC-1	MOB::Opl
AGTGGTGTTACCCGTG-1	MOB::Gr
AGTGTATTGCGCATTG-1	SS::L2/3
AGTTAAACACTTGCGA-1	MO::L5
AGTTAAGCGGTCCCGG-1	SS::L1
AGTTAAGTCAACCGCT-1	MOB::Gr
AGTTACTCTATCGTGG-1	SS::L2/3
AGTTCCTACAGAATTA-1	MO::L5
AGTTCCTATTTATGTT-1	CPu
AGTTGACGGTCCTTGC-1	AON::L2
AGTTGGCAAGGCTAGA-1	Pal::NDB
AGTTTGCACCTGCCTC-1	AcbC
AGTTTGGCACGGGTTG-1	Pal::GPi
AGTTTGGCCAGACCTA-1	ORB::L2/3
ATAAACGGACCCGTAA-1	CC
ATAAACGTTGCACCAC-1	Pal::Sl
ATAAAGGCTCGGTCGT-1	MO::L5
ATAAATATTAGCAGCT-1	FRP::L2/3
ATAACGCCGGAGGGTC-1	CPu
ATAACGGAGTCCAACG-1	MO::L5
ATAAGGTGGAGAACAT-1	CPu
ATAAGTAGGATTCAGA-1	CC
ATAAGTAGGGCGACTC-1	Fim
ATAAGTTACCGCGACG-1	ORB::L6
ATAATAGCTGTTGAAT-1	CC
ATAATCTTGGAGAACC-1	AcbSh
ATAATTAGCTAAGTAG-1	AON::L2
ATACAGGCCCTCCAAT-1	AcbC
ATACCACGGGCAACTT-1	MO::L2/3
ATACCGTCATCCATAA-1	SS::L2/3
ATACCTAACCAAGAAA-1	AcbSh
ATACGCCGGCGAAACC-1	CPu
ATACGGAACGTCGTTT-1	MOB::MI
ATACGGGTTTCGATTG-1	MO::L5
ATACGTACTTAGCCAC-1	AcbC
ATACGTCCACTCCTGT-1	CPu
ATACGTTATGCACGGA-1	En
ATACTACCCGTACCAC-1	Pal::Sl
ATACTAGCATGACCCT-1	MO::L2/3
ATACTGCCTTACACCG-1	AcbC
ATAGACAACGGGACCT-1	SS::L6
ATAGACGAAGAGAAAG-1	MO::L5
ATAGAGTACTGGGACA-1	MO::L2/3
ATAGAGTTATCAACTT-1	SS::L6
ATAGCAACTAGGGAAG-1	Pal::MA
ATAGCCATAACAGTCA-1	OT::Pl
ATAGGCGGCTATAGAA-1	ORB::L5
ATAGGCTAGCTTCGCA-1	SS::L6
ATAGGGATATCCTTGA-1	MO::L2/3
ATAGGTTGGGCAGATG-1	MO::L5
ATAGTGAAGCGTTCTC-1	CC
ATAGTTCCACCCACTC-1	CPu
ATATAAAGCGCTCGTG-1	AcbC
ATATAAATGTAGCTGC-1	AcbC
ATATAACACGGGCGCA-1	Pal::MA
ATATACATGTATGGTA-1	MOB::Gr
ATATACGCTCGTGACG-1	HY::LPO
ATATAGAGTATTGGTC-1	MOB::Gl_1
ATATCAACCTACAGAG-1	Fim
ATATCAATTCCAGCCT-1	MOB::Opl
ATATCGGTAGGGAGAT-1	Fim
ATATCGTTCCTCGAAC-1	Pal::Sl
ATATCTCCCTCGTTAA-1	SS::L2/3
ATATCTTAGGGCCTTC-1	MO::L6
ATATGTCTCCCTAGCC-1	CPu
ATATTCAGTTAAACCT-1	ORB::L5
ATATTCCACATAGTGA-1	CPu
ATATTTAACCCTCAAG-1	MO::L5
ATCAAACACTGTTCCA-1	TH::RT
ATCAAACGAAGGTTTG-1	ORB::L1
ATCAATCTGGGCTGCA-1	MO::L6
ATCAATGCCGTGGCTG-1	MOB::Gl_1
ATCACATTAGAATATC-1	SS::L2/3
ATCACGTGCTAATTAA-1	ORB::L2/3
ATCACTTCATCCTCGC-1	MO::L2/3
ATCAGACGGCACGCCG-1	ORB::L5
ATCAGCCTCATGCTGC-1	AcbC
ATCAGCTCGTCCACTA-1	MOB::Gr
ATCAGTAGGCAGGGAT-1	SS::L5
ATCATAGCCCTATGTA-1	Pal::MA
ATCATCCAATATTTGT-1	CC
ATCATTGTACCGCATT-1	MOB::Gl_1
ATCCAACGCAGTCATA-1	MO::L1
ATCCAATGGAGGGTCC-1	ORB::L2/3
ATCCACATCGACAGAA-1	AcbSh
ATCCAGAGCAACAACC-1	PIR
ATCCAGGATTCGTGAA-1	MO::L6
ATCCCATCCACAGCGC-1	MOB::Gl_1
ATCCTACCTAAGCTCT-1	ORB::L6
ATCCTGAATCGCTGCG-1	FRP::L2/3
ATCCTGCGTGGAATGG-1	ORB::L6
ATCGACCCAATACAGA-1	CPu
ATCGACTCTTTCCGTT-1	MO::L2/3
ATCGCACGCCGGGAGA-1	MO::L5
ATCGCCAGTCAACATT-1	St
ATCGCTGCGTGCAGCA-1	SS::L6
ATCGGAGACAGACGGC-1	AcbC
ATCGGCAAGCAGTCCA-1	SS::L5
ATCGTTAGCTAGCGGA-1	Pal::Sl
ATCTAATATCCTACGG-1	AcbC
ATCTACCATCTGCTCC-1	OT::Ml
ATCTAGCTTGTGAGGG-1	OT::PoL
ATCTCCCACGGAATAT-1	HY::LPO
ATCTCCCTGCAATCTA-1	MO::L1
ATCTGCACCTCTGCGA-1	CC
ATCTGCTGTTATCGCC-1	Io
ATCTGGGCTGTTCTTG-1	AcbSh
ATCTGGTTAAGACTGT-1	MO::L5
ATCTTATCGCACACCC-1	Pal::MA
ATCTTGACCTGCAACG-1	MO::L2/3
ATCTTGACTTGTCCAA-1	Or
ATGAAGCCAAGGAGCC-1	MO::L1
ATGACGCGTTCTATCC-1	AOB::Gr
ATGACTATGCGACATT-1	CPu
ATGAGGAGTGTTAATC-1	MO::L1
ATGATGCAATGGTACA-1	ORB::L6
ATGCACGCGCTGTTCA-1	MOB::Gl_1
ATGCACTACCGCATTG-1	MO::L2/3
ATGCATGATCCAGGAT-1	MO::L5
ATGCCAATCGCTCTGC-1	SS::L2/3
ATGCCATTTGCGACCA-1	CPu
ATGCCGGTCTTGCATA-1	MO::L6
ATGCCGGTTGATGGGA-1	SS::L2/3
ATGCGACAATTGGTCC-1	SS::L2/3
ATGCGACAGTCCCATT-1	CC
ATGCGAGTCCCACCAC-1	TH::RT
ATGCTCTGGCGCGGTA-1	AcbC
ATGCTTAGGAGTTGAT-1	HY::LPO
ATGGAAATTTAAGGAG-1	MOB::lpl
ATGGAGCAGGCCGTGA-1	CC
ATGGATCCGGCGTCCG-1	MO::L2/3
ATGGATTGACCAAACG-1	MO::L5
ATGGCAGCATTACGAT-1	MOB::Gl_1
ATGGGCCTCGGCCTCT-1	CPu
ATGGTCGCGTGGTTTC-1	CPu
ATGTAAGGCTGCTCTT-1	Py
ATGTACATGCGGTGAG-1	HY::LPO
ATGTACGATGACGTCG-1	AON::L2
ATGTAGCGCGCGTAGG-1	OT::PoL
ATGTGAAAGCCTAATG-1	AOB::Gl
ATGTGCATCCGACGCA-1	MO::L2/3
ATGTGGACATCTTGAT-1	CPu
ATGTTGATTAGAGACT-1	Pal::NDB
ATTAAACATGCGGACC-1	CC
ATTAATACTACGCGGG-1	MO::L2/3
ATTAATGAACCAGTCG-1	MO::L5
ATTACATGTCAGTCTT-1	TH::RT
ATTACGCGCTGGCAGG-1	FRP::L2/3
ATTACTTACTGGGCAT-1	SS::L5
ATTAGATTCCTCAGCA-1	CC
ATTAGGCGATGCTTTC-1	CPu
ATTATACTTTGCTCGT-1	MO::L2/3
ATTATAGCTACTTTAC-1	SLu
ATTATGCCATAGGGAG-1	MO::L1
ATTATTATGTCCGTCA-1	AOE
ATTATTCAGAGTCACT-1	Pal::NDB
ATTCAACCATTTAAGG-1	Pal::Sl
ATTCACTGATGTTGGA-1	AcbC
ATTCAGGACCTATTTC-1	SS::L5
ATTCATATACTGTCCA-1	CC
ATTCATCGTTGAGGCA-1	Pal::Sl
ATTCCCGAAGGTACAG-1	MOB::Gl_1
ATTCCTAAGACGTGGA-1	SS::L2/3
ATTCGACGCCGGGCCT-1	MO::L2/3
ATTCGCGCCTTGAGAG-1	Pal::MA
ATTCGTGCTATCTCTT-1	TH::RT
ATTGAAGATCTTAGTG-1	MO::L5
ATTGACCGGCGATGAC-1	SS::L6
ATTGATCACCACATTT-1	MOB::Gr
ATTGATGAGTCCTAAC-1	CPu
ATTGCCTTTATGTTTG-1	AcbSh
ATTGCGATCAGTAACT-1	Pal::GPi
ATTGCTGCTCCTCCAT-1	MO::L5
ATTGGATTACAGCGTA-1	Pal::Sl
ATTGGTTGTGCATTAC-1	OT::Pl
ATTGTACAACTCGGCT-1	CPu
ATTGTCGCAATACCTT-1	SS::L2/3
ATTGTGACTTCGCTGC-1	SS::L1
ATTTACAGTTTACTGG-1	MO::L2/3
ATTTACTAAGTCCATT-1	Py
ATTTCCGGGTTCTGCG-1	AOE
ATTTGCGCGAGTAGCT-1	Ft
ATTTGGAGATTGCGGT-1	MOB::Gl_1
ATTTGTCTTGGGAGCT-1	CPu
ATTTGTTCCAGGGCTC-1	MO::L2/3
CAAACCCTCCGGCGGG-1	OT::Ml
CAAACGAGTATCGCAG-1	ORB::L5
CAAACGGTCGCACTTT-1	MO::L2/3
CAAACTCGCGACGCCG-1	TH::RT
CAAAGATTATTGGGCC-1	MOB::lpl
CAAATCTCTCACAAGG-1	ORB::L1
CAAATGTCCTTCCGTG-1	Cl
CAACCTACCGAGCAGT-1	Pal::MA
CAACGACCCGTTTACA-1	MO::L1
CAACGTGGTGGAGTCT-1	HY::LPO
CAACTATATCGAATGC-1	SS::L1
CAACTGCTCATCCGAT-1	AON::L1_2
CAAGAGGGCGGAGTAC-1	CPu
CAAGATATTATAACGT-1	CPu
CAAGCAACGTCGGAGT-1	MO::L2/3
CAAGCACCAAATGCCT-1	MO::L1
CAAGCGGCACATAATT-1	AcbC
CAAGGATCGCATGTTC-1	CPu
CAAGGCCAGTGGTGCA-1	Pal::MA
CAAGGTCCTATAGGCT-1	Or
CAAGTGTGGTTGCAAA-1	CPu
CAATAAACCTTGGCCC-1	MO::L5
CAATACGCTCTGAGGC-1	MOB::Opl
CAATATTCTTGACCTA-1	AOE
CAATCCCTATACCAGC-1	SS::L1
CAATGCGAGAAGTATC-1	AcbC
CAATGGATCTCTACCA-1	MO::L6
CAATGTGCCAACCCTT-1	Fim
CAATTAAGGGTGATGA-1	MO::L5
CAATTGGGCCGCACTC-1	MOB::Opl
CAATTTCGTATAAGGG-1	CC
CACAAGAAAGATATTA-1	SS::L2/3
CACAATGAGCTGCTAT-1	ORB::L6
CACACACGCTAACGAG-1	Pal::Sl
CACACGCGCTGTCTTA-1	CPu
CACAGCACCCACGGCA-1	MO::L5
CACAGCTAGGGAGTGA-1	MO::L2/3
CACAGGGCCATATAGT-1	Pal::Sl
CACAGGGCCGTTGTCA-1	En
CACAGTCCCGCTTCGC-1	HY::LPO
CACAGTTCGCTTCCCA-1	TH::RT
CACATATTAGCAGGAT-1	CPu
CACATCTCACCGACGA-1	AcbC
CACATGATTCAGCAAC-1	CC
CACATTCTTTCGATGG-1	SS::L2/3
CACATTTCTTGTCAGA-1	TH::RT
CACCAATCATCCGTCT-1	MOB::Opl
CACCACGCCACACAGA-1	MOB::Opl
CACCAGTCAGCATGCA-1	MOB::Gl_1
CACCATGATCGCAAAG-1	SS::L1
CACCCAAATCTTATGT-1	LV
CACCCACGAGGCAATT-1	SS::L5
CACCCGGTTTGTGACT-1	AOE
CACCCTAACAAGATCT-1	AcbC
CACCCTTGGTGAGACC-1	MOB::Gr
CACCGCCAGAAGGTTT-1	MO::L5
CACCGCGTCCACTCTA-1	SS::L2/3
CACCGGGCATCACAAG-1	OT::Ml
CACCGTATCCCATCCG-1	Pal::Sl
CACCGTTAGGGATCAC-1	AOE
CACCGTTGCGCGATAT-1	ORB::L1
CACCTAATCAGTTTAC-1	MO::L2/3
CACCTCGATGGTGGAC-1	MO::L2/3
CACCTTGCGAAACTCG-1	MO::L5
CACCTTGGCGCCTTTG-1	St
CACGAAAGTTAGTCCC-1	MO::L2/3
CACGCACAGCGCAGCT-1	MO::L5
CACGCAGCGAGGCTTT-1	MO::L2/3
CACGCGGAACTGTTGC-1	St
CACGGCGCGCCAAAGG-1	SS::L2/3
CACGTCGGCAACCTCT-1	ORB::L2/3
CACGTTCGTGCTCTAG-1	CPu
CACGTTTCGTACACAC-1	Pal::Sl
CACTAAAGTTGCCTAT-1	MO::L5
CACTACGGGAGCTGCC-1	HY::LPO
CACTCAAGAGCTATGG-1	CC
CACTCCTATGTAAGAT-1	AOE
CACTCCTCTCGGTCGG-1	SS::L2/3
CACTCGAGCTGAACAA-1	CPu
CACTCTTCTGCTAGCC-1	Pal::Sl
CACTGACGATTGTGGA-1	Io
CACTTAATCAGACGGA-1	MO::L5
CAGAACTTAGCCCTCT-1	AcbC
CAGAATAACACACGGA-1	Pal::Sl
CAGACACCGATCGCTG-1	PIR
CAGACCTGTAAGTGTT-1	CC
CAGACGAACCTGATAC-1	PIR
CAGAGACGGTCACCCA-1	PIR
CAGAGCATGAGCTTGC-1	MO::L5
CAGAGGCGATGCATGA-1	PIR
CAGATAATGGGCGGGT-1	Pal::NDB
CAGATACTAACATAGT-1	MO::L2/3
CAGATCATTTAAAGTC-1	SS::L6
CAGATCCTGGTTTGAA-1	MOB::MI
CAGATGTTTGTCCCAA-1	MOB::Gr
CAGCAGCCCGTTCCTT-1	MO::L6
CAGCAGTCCAGACTAT-1	Pal::GPi
CAGCAGTCTGTGCTGC-1	AcbSh
CAGCCTCCTGCAGAGG-1	MO::L5
CAGCCTCTCCTCAAGA-1	SS::L2/3
CAGCGATTCCCTTCAA-1	AOE
CAGCTCACTGAGACAT-1	MO::L5
CAGCTCGACAAGTTAA-1	MO::L6
CAGCTGGCGTAACCGT-1	AOB::Gr
CAGCTTAGTAGGTAGC-1	MO::L1
CAGGATATATCGTTGT-1	CPu
CAGGCAGTCTTACCAG-1	OT::PoL
CAGGCCGTTTGGGTGT-1	MO::L5
CAGGCGCACGGTGGTC-1	MOB::Gr
CAGGCGCCATGCTAGG-1	CPu
CAGTAACTATTTATTG-1	SS::L5
CAGTAAGGGACGTCTC-1	MOB::Gl_1
CAGTACATTCTCTAAA-1	SS::L5
CAGTACCAGTTTACGT-1	AOB::Gr
CAGTAGCCCACGCGGT-1	SS::L5
CAGTCGAGGATGCAAT-1	SS::L6
CAGTCGGCCTAGATAT-1	MOB::Gr
CAGTCTGTATACTGGG-1	CPu
CAGTGAATAAATGACT-1	MO::L5
CAGTGTCGGCTGGCCC-1	Pal::Sl
CAGTTCAAATTGACAC-1	MO::L5
CATAACGGACAGTCGT-1	CPu
CATAAGAAGCTTGGCT-1	AcbC
CATAAGCTCTCCGTCT-1	MOB::Gr
CATACACAAAGTCAGC-1	MOB::Gl_1
CATACACGGTTCCCAC-1	AON::L2
CATACCCGTACCCAGT-1	FRP::L2/3
CATACGGCGTCTGGGC-1	CPu
CATACTATGTAATTGT-1	MO::L5
CATACTTAGGCAATAC-1	Fim
CATAGAGGAGATACTA-1	OT::Pl
CATAGCGTTGCCCACC-1	AON::L1_2
CATAGTACATTGAGAG-1	MO::L1
CATAGTCAAATACATA-1	Pal::MA
CATAGTCCACAAGAAC-1	ORB::L2/3
CATATACTACTGATAA-1	SS::L5
CATATAGGTACAGTCA-1	Cl
CATATGTCAGGCTACG-1	AOB::Ml
CATCATTACCCTGAGG-1	Pal::Sl
CATCCTCTCAAAGATC-1	Pal::Sl
CATCGGACGGGTTAAT-1	CC
CATCTATCCCGTGTCT-1	SS::L5
CATCTTACACCACCTC-1	CPu
CATGACTTCGCTGAAT-1	St
CATGAGATGCACTCTC-1	AcbC
CATGATGCACAATTCT-1	MO::L2/3
CATGATGGAAGTTAGC-1	St
CATGCCAACTCGCAAA-1	AOB::Gl
CATGCGACCAGTTTAA-1	SS::L6
CATGGATTGTCTTCCG-1	Pal::Sl
CATGGGTATGCCTTAT-1	AcbC
CATGGGTCGGGTGTGG-1	SS::L5
CATGGTAAGTAGCGTT-1	CPu
CATGGTATTAGTTTGT-1	MOB::Gl_1
CATGGTCTAGATACCG-1	MO::L5
CATGGTTTATTAATCA-1	Pal::NDB
CATGTAAGAGACATTT-1	Pal::Sl
CATGTAGGAGCGCCAA-1	SS::L2/3
CATGTCTCATTTATGG-1	CPu
CATTACGCAGGAAGGG-1	OT::Pl
CATTACGTCGGCCCGT-1	MO::L2/3
CATTATGCTTGTTGTG-1	MO::L5
CATTGCGGGTCAATTC-1	Or
CATTTAGCGGACCATG-1	MO::L5
CATTTGAGTGGTACGT-1	PIR
CCAAACAGAACCCTCG-1	MO::L1
CCAAATAACAAGATTC-1	TH::RT
CCAACGATGCACTGAT-1	MO::L2/3
CCAAGAAAGTGGGCGA-1	PIR
CCAAGACTTCTGCGAA-1	MO::L2/3
CCAAGCGTAACTCGTA-1	MO::L6
CCAAGGTTGCCCTTTC-1	Pal::NDB
CCAATAGTGCCGTCGA-1	MO::L5
CCAATCGGTAGATCGA-1	SS::L1
CCAATGTCACAGCAAG-1	MO::L5
CCAATTACGGGTCGAG-1	SS::L5
CCACAATGTACGTCTT-1	MO::L6
CCACACTGAGATATTA-1	MO::L6
CCACAGTACCCATCCT-1	CPu
CCACATGGCTCTTTAT-1	MOB::Opl
CCACCAACTTTACTGT-1	AOE
CCACCCAAGGAAAGTG-1	CPu
CCACGAATTTAACCTC-1	St
CCACGAGAAGAGAATC-1	MO::L2/3
CCACGGAGCCATAAGA-1	AOB::Gl
CCACGGTGCCCGGTAG-1	Fim
CCACTCAGATCCGCAA-1	OT::Ml
CCACTGGTGGCTGGTT-1	FRP::L1
CCACTGTTTGGATTAA-1	HY::LPO
CCAGAAAGCAACTCAT-1	AOE
CCAGATAGTTGAGTGA-1	MO::L6
CCAGCCTGGACCAATA-1	CC
CCAGCTCGAACGCATT-1	En
CCAGCTGATGGTACTT-1	FRP::L1
CCAGGGACGTGGCCTC-1	MO::L5
CCAGTAGTCTGATCCA-1	SS::L6
CCAGTCAAATCTCTTA-1	MOB::lpl
CCAGTCTAGACGGCGC-1	SS::L5
CCAGTCTTGTCATAGA-1	En
CCAGTTCGGTAACTCA-1	OT::Ml
CCATAACCTGTGCAGT-1	MOB::Gr
CCATACCTTTACTTGT-1	LV
CCATAGAGGCTGCCAG-1	MOB::Gl_1
CCATAGGTTGGCGTGG-1	MO::L1
CCATATGGAAACTATA-1	Pal::Sl
CCATCGCAGTTAAACT-1	Cl
CCATCTCACCAGTGAA-1	CPu
CCATGCCCTAGATTTC-1	Pal::Sl
CCATGCCTGTTTAGTA-1	MO::L5
CCATTAGCGATAATCC-1	MO::L2/3
CCATTCCCTGCCCACA-1	MO::L2/3
CCATTTCTACCTATTA-1	AcbC
CCCAAACATGCTGCTC-1	CPu
CCCAACATACGTCGCG-1	ORB::L5
CCCAAGTCATTACACT-1	Pal::NDB
CCCAATTTCACAACTT-1	FRP::L2/3
CCCACTCCACGGTATC-1	MOB::Gr
CCCAGAGGAGGGCGTA-1	SS::L5
CCCAGGTCTGAAGGCT-1	TH::RT
CCCAGTAAACTTGGGA-1	MOB::Gr
CCCAGTTAAGGCGCCG-1	CPu
CCCGAAGTTTCGCGAA-1	MOB::Gr
CCCGACCATAGTCCGC-1	MO::L2/3
CCCGAGTTTCTCCGTA-1	TH::RT
CCCGCAGCGCGAACTA-1	CPu
CCCGGGTCGTTCAGGG-1	AON::L1_1
CCCGGTGTATCGGAAT-1	MOB::Gr
CCCGTAAGTCTAGGCC-1	FRP::L2/3
CCCGTAGCTGGGAAGA-1	AOE
CCCGTCAGCGTCTGAC-1	MO::L2/3
CCCGTGAGGGCGGTGA-1	MOB::Gr
CCCGTTTCGCAGATGT-1	TH::RT
CCCTACTTGAACAATG-1	OT::Ml
CCCTAGGCAACAAGAG-1	MOB::Gr
CCCTATGTAGAGCAGA-1	MOB::Opl
CCCTCCTCGCTCGTAT-1	TH::RT
CCCTGAAATGAGTTGA-1	MO::L2/3
CCCTGCCCAATCCGCT-1	MOB::Opl
CCCTGCGCTACGCATA-1	MO::L1
CCCTGGCTGTTCCTTC-1	MOB::Gr
CCCTTTAATGGAGTTC-1	HY::LPO
CCCTTTGACAGGTCTT-1	PIR
CCGAACACTGGGCCTC-1	AOB::Ml
CCGAACCTTCCCGGCC-1	CPu
CCGAAGCATTGACCAA-1	MOB::Gl_1
CCGACAATAGGCCGCC-1	HY::LPO
CCGACGGGCATGAGGT-1	MOB::Gr
CCGACGTAAACACAAC-1	SS::L2/3
CCGAGAAGTCGCATAA-1	TH::RT
CCGAGCTGTGCTTGTC-1	SS::L5
CCGATCTCAACCTTAT-1	CPu
CCGATTCGAGGGACCC-1	FRP::L1
CCGCACAAAGACCAAC-1	CPu
CCGCACTTGCAATGAC-1	Pal::NDB
CCGCATGTGGTACGAT-1	AcbC
CCGCCGGAACTTCTCG-1	MOB::MI
CCGCCTGCGAATTGGT-1	SS::L2/3
CCGCCTTGCGATGTCG-1	MOB::Gr
CCGCGATTTGGTAGGT-1	MOB::Gl_2
CCGCGCAAGATACCCA-1	MOB::Gl_1
CCGCGGAATGCGTCAC-1	ORB::L2/3
CCGCGGGTACGAAGAA-1	MO::L1
CCGCTATCAGCACCAG-1	CPu
CCGCTCCAGGGCGATC-1	OT::Ml
CCGCTCTTCCGAACTA-1	Pal::MA
CCGCTTACCTCACTCT-1	ORB::L2/3
CCGCTTGCTGACATGG-1	Py
CCGGAGCGTACTTTCT-1	AON::L1_2
CCGGCACGACCGTTTC-1	Fim
CCGGCCGCGAGCATAT-1	MOB::Gl_1
CCGGCGTGAGACTCTG-1	MOB::Gr
CCGGGCGGTCTCGTCA-1	MO::L6
CCGGGCTGCTCCATAC-1	CPu
CCGGGTTCGAGGTTAC-1	FRP::L2/3
CCGGTAATGGCTAGTC-1	Fim
CCGGTTTGTAATTGTG-1	AON::L1_2
CCGTAAGTTGGTCCCA-1	CC
CCGTAGGAAATCCCTG-1	Pal::Sl
CCGTAGGGTTGTTTAC-1	Pal::Sl
CCGTATCTCGTCGTAG-1	MOB::Gr
CCGTATTAGCGCAGTT-1	SS::L5
CCGTGGAACGATCCAA-1	SS::L6
CCGTGTTAAATTCCAT-1	ORB::L2/3
CCGTTACGTTAGAACA-1	SS::L5
CCGTTCCGAATCTCGG-1	ORB::L1
CCTAAAGGCTGACGCT-1	SS::L1
CCTAAATTAACGGTTC-1	CPu
CCTAAATTGTATCCTA-1	TH::RT
CCTAACCCAAACAAGT-1	CPu
CCTAACTAAGGCTCTA-1	SS::L5
CCTACATTCACAGACG-1	Ft
CCTACTGCTTACACTT-1	MO::L2/3
CCTAGGCGTAGCGATC-1	CPu
CCTAGGTAAAGGTAGC-1	MOB::Gr
CCTATAATGAGTGCCC-1	AcbC
CCTATACCGTCCTGTC-1	AON::L1_2
CCTATATCGTGTCACG-1	MOB::Gl_1
CCTATATTTGTCCTGG-1	AON::L1_1
CCTATCTATATCGGAA-1	MO::L2/3
CCTATGAAGTGGTGCC-1	Fim
CCTATGGCTCCTAGTG-1	MOB::Gl_1
CCTATGGGTTACCGTC-1	MO::L6
CCTATGGTCAAAGCTG-1	OT::Pl
CCTATGTCCACTCCAC-1	Pal::MA
CCTCAACGATCGCTGT-1	MOB::lpl
CCTCACCTGAGGGAGC-1	CC
CCTCACCTTAGCATCG-1	SS::L6
CCTCCGACAATTCAAG-1	MO::L2/3
CCTCCTGAGCCCACAT-1	MOB::Gl_2
CCTCCTGTTGTGTCGT-1	Pal::MA
CCTCGCCAGCAAATTA-1	MO::L2/3
CCTCGCGCGATATAGG-1	SS::L5
CCTCGCGCTGTGCGAT-1	En
CCTCGGACCGGGATAG-1	CPu
CCTCTAATCTGCCAAG-1	MO::L5
CCTCTATCGATTAGCA-1	MOB::Gr
CCTCTCTCCCATCTAG-1	MO::L2/3
CCTCTGGCCTAGACGG-1	MO::L1
CCTCTGTACTATTCTA-1	En
CCTGAACGATATATTC-1	CPu
CCTGAATATTTACATA-1	MO::L5
CCTGACCACCGATGGT-1	CPu
CCTGCTATTTGAGAAG-1	MO::L2/3
CCTGGAAACGTTCTGC-1	Fim
CCTGGCTAGACCCGCC-1	MO::L2/3
CCTGGTCGAATGTGGG-1	AcbC
CCTGTAAGACATGATA-1	MO::L5
CCTGTACTCACGCCCA-1	ORB::L2/3
CCTGTCACCCGGGCTC-1	MO::L5
CCTGTCCCTCACGTTA-1	Fim
CCTGTCGCCCGTAAAT-1	MO::L6
CCTGTTTGAAGACACG-1	Pal::Sl
CCTTCAGTTAAAGTGA-1	AON::L1_1
CCTTCGTATAGAATCC-1	OT::Ml
CCTTCTCAGCGTTCCT-1	MOB::Gr
CCTTCTTGATCCAGTG-1	MO::L2/3
CCTTGACCACTTTATT-1	Pal::Sl
CCTTTAAGGGAGCACT-1	AON::L1_2
CCTTTCAATGAAGAAA-1	SS::L5
CCTTTGAATTATGGCT-1	MOB::Gl_1
CGAAACGCAATTCATG-1	ORB::L5
CGAACAGTATGGGCGT-1	Pal::GPi
CGAACCCGCATGCGTC-1	PIR
CGAACGGCCGGACAAC-1	MOB::Gr
CGAAGCTATAAATTCA-1	SS::L5
CGAAGTTGCTCTGTGT-1	MO::L2/3
CGAATCTGCTCGACGC-1	MOB::Gl_1
CGAATGAAGTCATTGC-1	MOB::Gl_1
CGAATGACGCATAATG-1	AON::L2
CGACAATTTGATCTAA-1	St
CGACACGCTCCGACAG-1	CPu
CGACAGTTCGCGTTAT-1	MO::L5
CGACCCTTAACGCCGG-1	MOB::Gr
CGACCTACTAGACAAT-1	MOB::Gr
CGACGCATCCGTACCT-1	MOB::Gr
CGACTCAGGATGTTAT-1	SS::L5
CGACTTTGTATAGCCT-1	Or
CGAGACCCTAGAGTGT-1	CPu
CGAGACTACTGCTGCT-1	OT::Ml
CGAGAGATGTGAACCT-1	MO::L6
CGAGAGCGCGTAGATA-1	MOB::Gr
CGAGAGCTTTCACTAC-1	Pal::MA
CGAGAGGGTAGCCGCG-1	Pal::Sl
CGAGCTGGGCTTTAGG-1	MO::L1
CGAGGCTAAATATGGC-1	MO::L6
CGAGGGACTGCGGTCG-1	CPu
CGAGGGTATCCAGGTG-1	AON::L2
CGAGTACTAAAGAGGA-1	ORB::L2/3
CGAGTGAAGGTACCAG-1	MOB::Gr
CGAGTTCTGTCCCACC-1	MO::L5
CGAGTTTATCGGACTG-1	CPu
CGATACCTCGCGGACA-1	MO::L6
CGATAGTCGTACTGCA-1	Pal::MA
CGATCCGACCCAGTGC-1	MO::L6
CGATCTGTTGGAGGAC-1	AOB::Gl
CGATGGACCCTACGCC-1	SS::L5
CGATGTTGTTATCTAC-1	MOB::Opl
CGATTAAATATCTCCT-1	AcbC
CGATTCGCCTGGCTGC-1	AcbC
CGCAAACACGAGTTAC-1	MO::L2/3
CGCAATTAGGGTAATA-1	MO::L2/3
CGCACATGTCCACTAC-1	CPu
CGCACGTGCGCTATCA-1	CPu
CGCAGATCTTCACCCG-1	Or
CGCAGGCGATCCAAAC-1	Pal::Sl
CGCATGCCGAATGCGT-1	Pal::MA
CGCATGGTGCGATGCT-1	CPu
CGCATTAGCTAATAGG-1	MO::L5
CGCCACAGGTCGCGAT-1	MOB::Gr
CGCCATCCGATTATGA-1	MO::L5
CGCCCAGCACGCCTAG-1	AON::L2
CGCCCAGCGTTTCACG-1	Pal::MA
CGCCCGCTTCCGTACA-1	SS::L2/3
CGCCGCCCATGCCTGT-1	CPu
CGCCGTTCAGCATAGT-1	Pal::Sl
CGCCTCCCTCCTCTAT-1	CPu
CGCCTGGCCTACGTAA-1	ORB::L2/3
CGCGAAGTGGCATACT-1	Pal::MA
CGCGACCGCGACAGAT-1	AcbC
CGCGAGAGGGACTTGT-1	SS::L5
CGCGAGTCTGCCGGGT-1	MOB::Gr
CGCGCAAATGTCCAGA-1	MOB::lpl
CGCGCATGTTTGATTG-1	PIR
CGCGCCCGACTTAATA-1	MO::L2/3
CGCGGCTCAACTTGAA-1	St
CGCGGGAATTAGGCAG-1	MO::L6
CGCGGGAATTCCTTTC-1	OT::Ml
CGCGGTCACAAACCAA-1	SS::L5
CGCGTTCATGAAATAC-1	MO::L5
CGCTACGGGACATTTA-1	MO::L6
CGCTAGAGACCGCTGC-1	CPu
CGCTATTCTTAGGCTC-1	CC
CGCTCTCCGTAGATTA-1	MO::L2/3
CGCTGGTGACTACCCT-1	Pal::GPi
CGCTGTGACGCCGCAC-1	MO::L2/3
CGCTGTGTGGATGTTG-1	AON::L1_1
CGCTTATTCCCGGTCG-1	ORB::L2/3
CGCTTCGGTCTAAGAC-1	Pal::NDB
CGCTTTCTTGCATTCG-1	CC
CGGAAAGAATCAAACG-1	AON::L2
CGGAACGTAAACATAG-1	ORB::L5
CGGACCTTTACGTCCC-1	OT::Ml
CGGACGTTACTTGAAG-1	MOB::MI
CGGAGCAATTTAATCG-1	En
CGGAGCATGGCGATCC-1	CPu
CGGAGTTTGAGAGACA-1	MO::L2/3
CGGATCCTCAAGGACT-1	AcbC
CGGCAAACATCGTGCG-1	AcbC
CGGCAATAAGATCGCC-1	Pal::Sl
CGGCAGGGTCGGGTTG-1	CPu
CGGCCACGCACAAAGT-1	MO::L5
CGGCCCAACCTGTAGT-1	Py
CGGCCCAGGTATATCC-1	St
CGGCGCCATCAATCCC-1	Pal::Sl
CGGCTCTAAAGCTGCA-1	TH::RT
CGGGAATATAGTATAC-1	TH::RT
CGGGAATTTATGTAAA-1	CPu
CGGGAGCTTCAGTGTA-1	CPu
CGGGATCAATGTAAGA-1	MO::L2/3
CGGGCAGCTAAACCGC-1	MO::L5
CGGGCCTTCTTTGTAA-1	MO::L6
CGGGCGATGGATCACG-1	OT::PoL
CGGGTGTACCCATTTA-1	CPu
CGGGTTTGTTAGGGCT-1	HY::LPO
CGGTACGGCAAACCCA-1	MOB::MI
CGGTACTAGAATCAAA-1	CPu
CGGTAGAGGTGCAGGT-1	SS::L5
CGGTATAGGTATTAGC-1	SS::L1
CGGTCAAGTGGGAACC-1	MO::L5
CGGTCCGTCGCAAGCC-1	AON::L1_1
CGGTCTATCAACCCGT-1	SS::L2/3
CGGTGAAGACTAAAGT-1	MO::L1
CGGTGCAGATAGAACG-1	ORB::L5
CGGTGCGCGTTGGTCC-1	ORB::L2/3
CGGTGGGCTCCAGCCT-1	SS::L2/3
CGGTTATCCAACAGTG-1	CC
CGGTTCAAGTAGGTGT-1	SS::L5
CGGTTGACCTGGCATA-1	FRP::L2/3
CGTACCTGATAGGCCT-1	MO::L2/3
CGTAGAGAGTAATTAT-1	OT::PoL
CGTATTAAGAGATCTA-1	MO::L5
CGTCACGTCCATTGGT-1	ORB::L6
CGTCCTCATCGCGTGC-1	Pal::NDB
CGTCGCATGTGAGCCA-1	OT::PoL
CGTCGGATAGTGTTGA-1	CPu
CGTCGGGTCTAAGCGC-1	MOB::Gr
CGTCGTCCTTCGCGAA-1	AcbC
CGTGAAGTTAATTCAC-1	MO::L6
CGTGACATTGGGTCGT-1	SS::L1
CGTGACCAGTCCTCTG-1	AON::L1_1
CGTGCACACCACTGTA-1	OT::Ml
CGTGCAGACTGGGACA-1	CPu
CGTGCATTGTCGACGC-1	FRP::L2/3
CGTGCCCTCCCGAAGA-1	CPu
CGTGGCCGAATATCTA-1	Pal::GPi
CGTGTATGGGAGCTGA-1	Pal::NDB
CGTGTCCCATTCGCGA-1	MO::L2/3
CGTTAAACTAGTTAGG-1	TH::RT
CGTTAATGTCCCGACG-1	Pal::Sl
CGTTAGCTCACAACTG-1	SS::L2/3
CGTTATCATACTTCCA-1	MOB::Gr
CGTTCAGACCCGCGAA-1	AON::L2
CGTTCATGGTGCGCGT-1	AOB::Gr
CGTTCTTCGCACACCT-1	SS::L5
CGTTGAATACCGCGCT-1	AcbC
CGTTGAGCGACCGTCG-1	CPu
CGTTGAGTAATTGCGT-1	SS::L1
CGTTGTAAGATTGATT-1	CC
CGTTGTCGGCAATTGA-1	En
CGTTGTTTCAATTCCC-1	MO::L2/3
CGTTTCACTTCGGGCG-1	SS::L2/3
CGTTTCGCTCATTACA-1	MO::L5
CGTTTGTGTAGAGGGT-1	AON::L1_2
CTAAAGAATGCCTACT-1	MO::L5
CTAAAGGGAAATAGGA-1	CPu
CTAAATCCTATTCCGG-1	MO::L5
CTAACAGCACAATAAC-1	MOB::Gl_1
CTAACCGCGCGCCCGT-1	MO::L5
CTAACGAAACTTGCTG-1	CC
CTAACTGATAATCGCC-1	Pal::Sl
CTAACTGGTCCGGTTC-1	ORB::L1
CTAAGGGAATGATTGG-1	CPu
CTAATTCGCACGCGCT-1	MO::L1
CTAATTCTCAGATATT-1	CC
CTACACTCGCAGATGG-1	Pal::Sl
CTACCCTAAGGTCATA-1	CC
CTACGACTAGCTATAA-1	FRP::L1
CTACGCACGGAGTACC-1	MO::L5
CTACTATCATAGGTTT-1	MOB::Gr
CTACTATCTTTCAGAG-1	CC
CTACTCAAGGTATAGT-1	Io
CTACTCTAGGCCCGGC-1	MO::L1
CTACTGCCACCTGACC-1	MO::L5
CTAGATGTGAGTGTAA-1	LV
CTAGATTTACGACGGC-1	CPu
CTAGCATAGTATAATG-1	MO::L6
CTAGCCGATGTTATGA-1	SS::L6
CTAGGCGCCCTATCAG-1	CPu
CTAGGTCTGAAGGAAT-1	LV
CTAGGTTCGGACGTGA-1	AcbC
CTAGTAGAAAGGGATT-1	AcbSh
CTAGTCACGTCTTAAG-1	CPu
CTAGTGAAGGACAGGA-1	MO::L2/3
CTAGTTACAACCCGGT-1	AcbC
CTAGTTGGGCCCGGTA-1	MO::L5
CTATAAGAGCCAATCG-1	SS::L6
CTATACTTAAAGCGAG-1	MOB::Gl_1
CTATCGACGAAATACA-1	Pal::Sl
CTATCGGGTCTCAACA-1	CC
CTATGCCCGAATGCAA-1	AON::L2
CTATGGGAAGCGGAAT-1	Pal::Sl
CTATGTCACTAGCCCA-1	MO::L5
CTATGTGAGTCACGGC-1	AOB::Gr
CTATTCATGTGTCCCA-1	Cl
CTATTGTGTTTGGTCA-1	SS::L2/3
CTATTTGCTTGGAGGA-1	OT::Ml
CTATTTGGTTACGGAT-1	CPu
CTCAACTAACCCGGAT-1	Pal::MA
CTCAAGACATTAGCGC-1	SS::L2/3
CTCACATTTACTAAAT-1	AcbSh
CTCACTGTGATACTTA-1	AcbSh
CTCACTTGGCTGGTAA-1	FRP::L2/3
CTCAGATTGTGATAAG-1	MOB::Gr
CTCAGTCACGACAAAT-1	SS::L5
CTCATAAATGTGTATA-1	OT::Ml
CTCATGGTAATTTGCG-1	Ft
CTCATTGCTCTAACAA-1	AcbC
CTCATTTGATGGGCGG-1	MO::L2/3
CTCCCTCCTTTCGATC-1	MOB::Gr
CTCCGCCCACATGAGG-1	ORB::L5
CTCCGGCCTAATATGC-1	MO::L1
CTCCTCCAGCTCACAC-1	AON::L1_1
CTCCTTTACGCAAGTC-1	SS::L6
CTCGAGACATACGATA-1	MOB::Opl
CTCGAGGTCGAACAGT-1	MO::L5
CTCGATATTTGCGAGC-1	SS::L5
CTCGCACCTATATAGT-1	MO::L5
CTCGCATTGCATAGCC-1	MOB::Gl_1
CTCGCCGAATGTAGGG-1	AcbSh
CTCGCTAGGTAAGCGA-1	OT::Ml
CTCGGTACCACTGCTC-1	CPu
CTCGGTTGTCGGCCCT-1	MOB::lpl
CTCGTCGAGGGCTCAT-1	MOB::Gl_1
CTCGTCTGTGCCTTCG-1	OT::Pl
CTCGTTTCTAATGTTT-1	SS::L5
CTCTAATGCATTGATC-1	CC
CTCTACACTGGCGATT-1	AOB::Gr
CTCTAGCCCTCGGAAA-1	Pal::MA
CTCTATTTGGCTGCAG-1	CPu
CTCTCACAATCGATGA-1	MO::L6
CTCTCTAACTGCCTAG-1	MOB::Opl
CTCTGGACGCCTGGTG-1	MO::L5
CTCTTCTATTGACTGG-1	St
CTCTTGTCCCGCTTGG-1	En
CTGAAAGAGATCCGAC-1	MO::L2/3
CTGAATCCGAGACCTC-1	ORB::L6
CTGAATTTATTGCCAG-1	SS::L5
CTGACTGCGCAGCTCG-1	LV
CTGCAAGCACGTTCCG-1	HY::LPO
CTGCACAACTACATAT-1	CPu
CTGCACTCCAGTACAG-1	AcbC
CTGCAGAGAATCAGAG-1	Pal::MA
CTGCCAAGGTTGGAAG-1	MO::L2/3
CTGCCATGCATCACAT-1	CPu
CTGCCTTTCTAGTAAA-1	Pal::MA
CTGCGACCTCGCCGAA-1	OT::Ml
CTGCGTTACGATATAA-1	SS::L2/3
CTGCTGAGGCCACGAA-1	ORB::L2/3
CTGCTTGGCGATAGCT-1	AcbC
CTGCTTTATGTCCGCG-1	SS::L5
CTGGAAATGGATGCTT-1	MO::L5
CTGGAAGACACGGTGG-1	CPu
CTGGACGCAGTCCGGC-1	MOB::Gr
CTGGATTTACACTTGA-1	PIR
CTGGCATCCGAATGAG-1	AOB::Gl
CTGGCGACATAAGTCC-1	SS::L2/3
CTGGCGATTTACATGT-1	OT::Ml
CTGGCGCACAGGTCTG-1	CPu
CTGGCTGATTCATCCT-1	St
CTGGCTGGTTGTCAGT-1	PIR
CTGGGATAAATAATGG-1	CPu
CTGGGCCTGCTATATC-1	ORB::L2/3
CTGGGTAGGCAGTTAA-1	CPu
CTGGGTTGAGTTAAAG-1	MOB::lpl
CTGGTAAAGACTTACA-1	OT::Pl
CTGGTAACACATAGAA-1	CPu
CTGGTAACGAGCTCTT-1	CC
CTGGTTTCGAGCAAGA-1	CPu
CTGTACTTCTTAGCAT-1	MO::L6
CTGTAGCCATCTCACT-1	AON::L1_2
CTGTCAAATGGCTCGG-1	SS::L5
CTGTGCAGGGTAGGTC-1	CPu
CTGTGGTCGGGAGATA-1	Pal::Sl
CTGTTACCCAATCTAG-1	Cl
CTGTTCACTGCCTGTG-1	MO::L2/3
CTTAACTTACAGTATA-1	Pal::NDB
CTTAAGCAGCGAGCCG-1	MOB::Gr
CTTACACGGTATTCCA-1	MO::L2/3
CTTAGCCTTCCACATG-1	MO::L5
CTTAGGTATAGACCAG-1	MOB::Gl_1
CTTAGTAGGCCTACAG-1	LV
CTTAGTGTAGTAGCAT-1	Pal::MA
CTTATGCGCTCAGGGC-1	MOB::Gr
CTTCAACTCCACTTGG-1	AcbC
CTTCAGTGGTCGCCTA-1	MOB::lpl
CTTCAGTTGGACAACG-1	OT::Ml
CTTCATTGTCAGTGGA-1	MO::L6
CTTCCGCTCCGTGAAG-1	AON::L1_2
CTTCGATTGCGCAAGC-1	OT::Pl
CTTCGGCCAATTGTTT-1	TH::RT
CTTCGTAGATAGGTGA-1	MO::L5
CTTCTATGTTGAAGTA-1	ORB::L1
CTTCTATTAATGCTAG-1	ORB::L2/3
CTTGAGTTAGGGTAAT-1	CPu
CTTGATGACCATCCAG-1	Pal::NDB
CTTGCAACCGCCTCCT-1	ORB::L1
CTTGCCCACCCACGCA-1	Pal::NDB
CTTGCCCAGGCTCTAC-1	Cl
CTTGGCCAAGCTGGGA-1	AON::L2
CTTGTACTTGTTGACT-1	MO::L1
CTTGTCAACATTCGAG-1	CPu
CTTGTGCTCACCGATT-1	SS::L5
CTTGTTGCTGAGTCAA-1	CPu
CTTTAACTTTCAAAGG-1	MO::L5
CTTTAATATTGGTCGA-1	CPu
CTTTACCGAATAGTAG-1	CPu
CTTTAGGAACACTGTT-1	CPu
CTTTAGTGCTATTATT-1	CPu
CTTTCTGTGCGGGCTT-1	AcbC
CTTTGACGTCGCTTCT-1	MOB::lpl
CTTTGCATCGCTCTTG-1	Pal::Sl
CTTTGGCTTTAGTAAA-1	MO::L2/3
CTTTGTCGAATGCTCC-1	MOB::Opl
GAAACAGATGACCACC-1	CPu
GAAACATAGGAAACAG-1	MOB::Gl_1
GAAACCATGGTGCGCT-1	Or
GAAACCGAATTACCTT-1	ORB::L6
GAAACCTATACAAATG-1	AON::L2
GAAAGAACAGCGTTAT-1	CPu
GAAAGCAGTGCACTTT-1	AON::L1_2
GAAAGCCCTTTGGACC-1	MO::L1
GAAATATCACCATCAG-1	MO::L1
GAAATATGCTTGAATG-1	SS::L5
GAAATCGCGCGCAACT-1	MO::L2/3
GAAATGGCGGTGTTAG-1	MO::L5
GAAATTAGCACGGATA-1	SS::L5
GAAATTGTCTCTATAA-1	Cl
GAACAACTGGGATGAA-1	OT::PoL
GAACACACATCAACCA-1	MO::L2/3
GAACAGATTACTAAAT-1	AcbC
GAACCCTCTGTGTTCT-1	AcbSh
GAACCTCGACCTACAC-1	MOB::Opl
GAACCTTTAACGATCC-1	AcbSh
GAACGACCGAATGATA-1	MO::L2/3
GAACGCGGGTCACACG-1	TH::RT
GAACGTCTCATGGTCG-1	CC
GAAGAAACGATATTGT-1	MOB::Opl
GAAGCCACTGATTATG-1	AcbSh
GAAGCCTGCACATTCC-1	En
GAAGCGTGAGGAATTT-1	MO::L5
GAAGCTCGGACCCGTC-1	MOB::lpl
GAAGCTTGCTGACCGC-1	MO::L2/3
GAAGGAGTCGAGTGCG-1	AON::L1_1
GAAGTCAGTTGCACTA-1	PIR
GAAGTCTCCCTAGCGA-1	CPu
GAAGTGATTTATCGTG-1	MO::L6
GAAGTTTCCACTCAAT-1	MO::L5
GAATAGACGCGACCCA-1	CPu
GAATAGCCCTGCGGTC-1	SS::L5
GAATCGACATGGTCAC-1	MO::L2/3
GAATCTGAACATTCTC-1	CPu
GAATGCGAATCGGTTC-1	AcbSh
GAATGGGCTTATCGAC-1	MOB::Opl
GAATGTATGGCAGGTC-1	SS::L2/3
GAATGTGGTCCGGATT-1	CPu
GAATGTTGGGTAATCT-1	MO::L5
GAATTATAGTGAAAGG-1	CC
GAATTCACCCGGGTGT-1	Cl
GAATTTCTCGCTGCAG-1	MO::L1
GACAAACATATGCAGG-1	St
GACAACGACCATTGAA-1	MO::L5
GACAACGCAGCTTACG-1	MO::L1
GACACAAGGGAAGAAA-1	MO::L6
GACACAGCCGGGACTG-1	OT::Pl
GACACTGAGTTCAGTG-1	ORB::L6
GACACTGGAACCCGAT-1	TH::RT
GACACTTCCAATTACC-1	OT::Pl
GACAGATTTCTGGCTC-1	MOB::Gr
GACAGCCAGACCTGAC-1	CPu
GACAGGCACACACTAT-1	FRP::L1
GACATCCGTCGAACTG-1	AcbSh
GACATCGATTTATAAC-1	PIR
GACCAAACGTTGACTG-1	HY::LPO
GACCACACTTCCCTTT-1	OT::Pl
GACCAGAGCCCTGTAG-1	MO::L5
GACCCAATTATGATAC-1	MOB::Gr
GACCGACGTGAAAGCA-1	Fim
GACCGACTGAAGCGTC-1	MO::L1
GACCGCGTCTGACGTG-1	TH::RT
GACCGTGCTGACGGTG-1	MO::L6
GACCGTTACATGCGAC-1	MOB::Gl_2
GACCTTCCACGTCTAC-1	OT::PoL
GACGACGATCCGCGTT-1	AcbC
GACGAGGCTAATAAAC-1	Pal::Sl
GACGCATACCCGTCGG-1	MOB::Gl_1
GACGCCGTAAAGGCTA-1	PIR
GACGCTTGCTTCTAAA-1	MO::L5
GACGGGTTGGCCCGTA-1	AON::L1_1
GACGGTCAATAGAAGC-1	CC
GACGTGTAGGGATTAT-1	MO::L1
GACTAAGATCATGCAC-1	MO::L2/3
GACTAAGTAGGCTCAC-1	MO::L2/3
GACTACAAAGCGGTGG-1	MOB::Gr
GACTAGGCCGTTAGGT-1	OT::PoL
GACTCACCCACGTGAG-1	Fim
GACTCCCAGAATAAGG-1	Or
GACTCCTTCCAATTGA-1	MOB::Opl
GACTCGCGGGAATGAC-1	SS::L6
GACTGCAAATCGAGCT-1	AcbC
GACTGCACCAGCCCAG-1	CPu
GAGAACGGTTCTGACT-1	Pal::NDB
GAGACCCTGCAACGCC-1	SS::L1
GAGACTGATGGGTAGA-1	MO::L5
GAGACTTCGCGACCGA-1	PIR
GAGAGGGCGCGAGGTT-1	MO::L5
GAGAGGTGCATTCTGG-1	ORB::L2/3
GAGATCTGCTTGGCAT-1	MO::L5
GAGATCTGTCACTCCG-1	MO::L6
GAGATCTTCCATGACA-1	CPu
GAGATGGCTTTAATCA-1	OT::Pl
GAGATGGGAGTCGACA-1	AcbC
GAGCACCTGTGTCCAG-1	AcbC
GAGCCAGCTACCTGTG-1	AcbC
GAGCCGAGCGTTTATT-1	SS::L2/3
GAGCGCAAATACTCCG-1	TH::RT
GAGCGCGCACGAGTAG-1	CPu
GAGCGCTGTTAGGTAA-1	MOB::Gl_1
GAGCTAAGGGCATATC-1	MO::L6
GAGCTGTCGTCTCGGA-1	SS::L5
GAGGAATGGAGAGGTT-1	MO::L1
GAGGATAAACAGTGCT-1	TH::RT
GAGGCCCGACTCCGCA-1	MOB::Gr
GAGGCCTGTTGATACA-1	Pal::MA
GAGGCTATCAAAGTCG-1	MO::L2/3
GAGGGCGCAGCTCTGC-1	SS::L6
GAGGTACGCGTGTCCC-1	OT::PoL
GAGTAAGGCCACGGGA-1	MOB::Gr
GAGTAGATACTAGTTG-1	AcbSh
GAGTATGCCCGCCTTG-1	ORB::L2/3
GAGTATGCGCGTGCAT-1	AcbSh
GAGTCAGACCAGAATC-1	AON::L1_2
GAGTCCGCTTACCGGA-1	Cl
GAGTCTTGTAAAGGAC-1	MOB::Gr
GAGTGTCAACCAGAAA-1	AcbSh
GAGTGTGCGGTACCCA-1	CPu
GAGTTCTGTGGGTGCT-1	MOB::Gl_1
GAGTTGATGGCAATTT-1	MOB::Gr
GATAACTCGCACTGTG-1	CPu
GATACGATGGGAGTCA-1	ORB::L6
GATAGATAGTACAGTC-1	OT::Ml
GATAGGTAACGTTGAC-1	Cl
GATATCAAGCAGGAGC-1	MOB::Opl
GATATGAGACACTAAC-1	CPu
GATATGCGGTAGCCAA-1	SS::L5
GATATTGAGATTGGCG-1	CPu
GATATTTCCTACATGG-1	SS::L2/3
GATCATTCCAAACATT-1	MO::L5
GATCCCTTTATACTGC-1	MO::L5
GATCCGGGAATTAACA-1	CPu
GATCCTAAATCGGGAC-1	SS::L6
GATCCTCGACACTGGC-1	ORB::L1
GATCGACACTATCTGA-1	MO::L2/3
GATCGCGGGCTCTCCA-1	MO::L5
GATCGCTACCCGATTT-1	Pal::GPi
GATCGCTATATCTCAG-1	MOB::Gl_1
GATCGGATAGAACCAT-1	MOB::MI
GATCGGTGGCCATAAC-1	MO::L5
GATCGTGACTGATATC-1	CPu
GATCTAACCGTATTCA-1	MOB::Gr
GATCTGCTATCTAAGG-1	AON::L2
GATCTTGGAGGGCATA-1	CPu
GATCTTTGCAGGGTAT-1	MO::L5
GATGACAAGTAGGGCA-1	Ft
GATGACGATGATCGCG-1	SS::L5
GATGAGGAACCTTCGG-1	OT::PoL
GATGCCTTCTGCGGCA-1	MOB::Opl
GATGCGTCCTGCATTC-1	MO::L6
GATGCTGTATTTCATC-1	CPu
GATGTAACGAACCACC-1	MOB::Gr
GATGTTCAATCCACGA-1	ORB::L6
GATTAACCGAAAGCCC-1	Pal::Sl
GATTACTGAATTTGGG-1	ORB::L5
GATTCCCTTGTCGCAG-1	MO::L5
GATTCCGCGTTTCCGT-1	MO::L1
GATTCGACGGTTCACG-1	CPu
GATTGGGAAAGGTTGT-1	OT::PoL
GCAAACCCTACATTAT-1	CPu
GCAAACCTTGGCCATA-1	AcbC
GCAAATATTACGCTTT-1	MO::L5
GCAAATGAGGACACTT-1	MOB::Opl
GCAACACACTAGAACT-1	AOB::Gr
GCAACAGCAGTATGCG-1	TH::RT
GCAACCACCAGACCGG-1	SS::L2/3
GCAACCACGGCCGCGT-1	ORB::L2/3
GCAACGGCTAGTTATG-1	TH::RT
GCAAGAATTCCTTGGC-1	ORB::L5
GCAAGATGTGTTCGCG-1	SS::L1
GCAAGCTGGAAACCGC-1	MOB::Opl
GCAAGTGCACAGAGAA-1	MO::L1
GCACAAACGAGGCGTG-1	TH::RT
GCACAACCTCGGGCGT-1	MOB::Opl
GCACACACTGGTAGCC-1	Pal::Sl
GCACCTAGGCGAGTCC-1	OT::Ml
GCACGCCGATTCCCGC-1	OT::Ml
GCACGCCTACTTAGAT-1	AOE
GCACGTGGTTTACTTA-1	Pal::MA
GCACTGCCTACCTTTA-1	OT::PoL
GCAGACCCAGCACGTA-1	CPu
GCAGATCCATAAGACT-1	CPu
GCAGATTAGGGATATC-1	CC
GCAGCACACAGCCCAG-1	MO::L5
GCAGCCTATATCACAT-1	Fim
GCAGCTATGGACAGGT-1	SS::L2/3
GCAGCTGTCAACGCAT-1	OT::Ml
GCAGGAACTTAGATCT-1	MOB::Gr
GCAGGACTATAGAATA-1	MO::L2/3
GCAGGTAGAGTATGGT-1	SS::L5
GCAGTGTGGCTATAGG-1	AcbC
GCATAGAGCACTCAGG-1	MO::L6
GCATCGGCCGTGTAGG-1	Pal::GPi
GCATGAGGGACGCGGC-1	CC
GCATGCTAATAACGAT-1	Pal::NDB
GCATGGGTACTGACGC-1	MOB::Opl
GCATTCAAGGCAACGC-1	Or
GCATTGACTTGCGGAA-1	MOB::Gr
GCATTGTAATTCATAT-1	ORB::L1
GCATTTCCAAGGCTCC-1	Or
GCCAACCATTTCCGGA-1	CC
GCCAAGAATACTTCTG-1	MOB::Gr
GCCAATAGGGCATCTC-1	SS::L6
GCCACAATTTAAGGAC-1	ORB::L5
GCCACTCAGAGCGCGA-1	Pal::Sl
GCCAGGAGTAACCGAT-1	SS::L5
GCCATATTGCACACAG-1	SS::L5
GCCATCGAGCTGCGTG-1	PIR
GCCATCGATGCTGCAT-1	Or
GCCATTAGCCTCAAAC-1	MOB::Opl
GCCCGACTTCTTCCCG-1	AOB::Ml
GCCCGAGAGTCTAAAT-1	MOB::Gl_1
GCCCGATCTGTGGTCG-1	Cl
GCCCGCGCGTAAACGG-1	ORB::L2/3
GCCCGTAATACCTTCT-1	MO::L5
GCCCTAGCCGTCGCGA-1	MOB::lpl
GCCCTGAGGATGGGCT-1	OT::PoL
GCCGAAATTCCTACGT-1	MO::L5
GCCGATTGGCCAAGCT-1	CPu
GCCGCTTGTGAGAAAC-1	MO::L5
GCCGGGTTAGGGTCGC-1	CC
GCCGTGGAAGAAATGT-1	Not_annotated
GCCTACGTTCTGTGCA-1	OT::PoL
GCCTATAGTGTCAGGG-1	MO::L6
GCCTATGCTGGGCCTT-1	SS::L5
GCCTCATCTGGAAATA-1	CPu
GCCTCCGACAATTCAC-1	Pal::Sl
GCCTCTATACATAGCA-1	AcbC
GCCTTTGTCAGTGGAC-1	MOB::Gl_1
GCGAAACGATCGGGAG-1	Pal::Sl
GCGAAACTTAACTGGA-1	CPu
GCGAAGAATCTGACGG-1	OT::PoL
GCGAAGCCATACCCGT-1	MO::L5
GCGACATGTAAACATC-1	Fim
GCGACGATAGTTGTAC-1	PIR
GCGAGAGGCCATGTAA-1	SS::L6
GCGAGAGTTGCGTCCA-1	Or
GCGAGCGCATGCTCCC-1	Fim
GCGAGGCCCGAGCAGA-1	MO::L5
GCGAGTTCTGCAAAGA-1	MO::L6
GCGATTGTTAACGTTA-1	CPu
GCGCAAATATATTCAA-1	MOB::Opl
GCGCAAGAGCGCGCTG-1	St
GCGCATCCAGTCAGCA-1	CC
GCGCCGTTCCACGATA-1	CPu
GCGCCTCCCACTCCGA-1	TH::RT
GCGCGGTCTAGTAACT-1	OT::Ml
GCGCGTCATTGGTACA-1	AcbC
GCGCTAATTGAATAGA-1	CC
GCGCTATGCCGAGGCA-1	ORB::L6
GCGCTGATCCAGACTC-1	SS::L2/3
GCGCTGCTTTGCATTT-1	SS::L6
GCGCTTAAATAATTGG-1	AcbC
GCGGACCGCGTTGTGG-1	ORB::L2/3
GCGGAGAAACTTCGCA-1	Ft
GCGGAGAGGGAGAACG-1	CPu
GCGGATTACTTGTTCT-1	OT::Ml
GCGGCAAAGTATTGCC-1	MOB::Opl
GCGGCTCTGACGTACC-1	MO::L5
GCGGCTTTAGCAAGTT-1	OT::Pl
GCGGGCGAGCCTTACC-1	PIR
GCGGTCTTGCTTTCAC-1	OT::Ml
GCGGTGAACTGCGCTC-1	SS::L5
GCGGTTCCCTATCATG-1	ORB::L6
GCGTAAATGGCCATAA-1	CPu
GCGTCGAAATGTCGGT-1	MO::L1
GCGTCGCCAGGGTGAT-1	AcbC
GCGTCTCTGCATTGGG-1	MO::L5
GCGTGGTACTGGGTTA-1	CPu
GCGTTCGGAGACCGGG-1	SS::L5
GCTAACTGAAGTCTGA-1	AcbC
GCTAAGCCCAGTATGC-1	OT::Ml
GCTAAGTAGTTTCTCT-1	CPu
GCTAATACCGAATGCC-1	MO::L1
GCTACAATCGAGGATA-1	Pal::MA
GCTACAGTACGGACCG-1	MOB::Opl
GCTACGACTTATTGGG-1	CPu
GCTACTATAGTAGAGT-1	Pal::GPi
GCTAGACCGTCTACTG-1	St
GCTAGAGTAGAGATGT-1	Pal::Sl
GCTAGCAGGGAGTGGG-1	SS::L2/3
GCTAGCTTGAATAGCT-1	ORB::L1
GCTAGGCACCACGGAG-1	AcbC
GCTAGTAGAGCTTGTA-1	CPu
GCTATACGTCTCGGAC-1	AcbC
GCTATCATACTCATGG-1	AcbC
GCTATGCCAGCTTATG-1	MOB::Gr
GCTCAATCCGTTTATT-1	AOE
GCTCAATGTAATACCG-1	AON::L2
GCTCATTACTGCATGT-1	SS::L1
GCTCCCAGTCGGTCCA-1	TH::RT
GCTCCGCTCGCTTCAG-1	TH::RT
GCTCCTGACATACTGG-1	Ft
GCTCGCTCATGTCCAA-1	St
GCTCGGAATTTAAAGC-1	SS::L5
GCTCTAAACCCTGACG-1	MO::L2/3
GCTCTATGTTACGTGC-1	MO::L2/3
GCTCTCGGGTACCGAA-1	MO::L5
GCTCTTTCCGCTAGTG-1	AON::L1_1
GCTGAATCTTCCAATC-1	MOB::Opl
GCTGAGGCGTGAGTAT-1	CPu
GCTGCACGGTTTCTTA-1	CPu
GCTGCTAAGTAGTCGA-1	AON::L1_2
GCTGCTACTGCGTAGC-1	CPu
GCTGCTCTCCGGACAC-1	MO::L5
GCTGGACCCAAAGTGG-1	SS::L2/3
GCTGGCATATTCACCT-1	MO::L2/3
GCTGGCGGCGCATGCT-1	AcbC
GCTGGTGACTCGTAGT-1	SS::L1
GCTGGTTTAGGCCATA-1	MOB::Gl_1
GCTGTATTACTGGCCC-1	ORB::L5
GCTGTTGCTACCGAAC-1	CPu
GCTTAATGTAACTAAC-1	CPu
GCTTACGTAGTTAGTA-1	Fim
GCTTATGAAGCAGGAA-1	CPu
GCTTCCATGTAACCGC-1	OT::Ml
GCTTCCGTCCCTAGAC-1	MO::L6
GCTTGAGTGACCTCTG-1	OT::Pl
GCTTGGATCGATTAGG-1	CC
GCTTTCAGAGGAGGTG-1	CPu
GGAAACCTTGTTGAAT-1	SS::L5
GGAAACTAAATGGGCC-1	Pal::Sl
GGAAAGTGCCCATGCC-1	SS::L5
GGAACCGTGTAAATTG-1	ORB::L5
GGAACCTTGACTCTGC-1	MOB::Opl
GGAACTTTGGCGATTA-1	HY::LPO
GGAATGCGCTAGCGTG-1	CC
GGACAACCATGAAGCC-1	Pal::NDB
GGACACAAGTTTACAC-1	TH::RT
GGACCAACAGGATAAC-1	CPu
GGACCTACGGTAACGT-1	SS::L5
GGACCTCTAGGCCGCC-1	MOB::Opl
GGACGTCCATAGTTGG-1	SS::L2/3
GGACTCTTTGACTAAG-1	OT::Ml
GGAGAAGTCATTGGCA-1	MO::L1
GGAGACCATCTACATA-1	MOB::Gr
GGAGACGACACCTTTG-1	CPu
GGAGCAACATTTCAAG-1	Pal::Sl
GGAGCACCAAGAACTA-1	MO::L5
GGAGCGAGGCCTACTT-1	OT::PoL
GGAGGGCTTGGTTGGC-1	CC
GGAGTTGATTCTGTGT-1	Pal::NDB
GGATCAGAGCCATCAG-1	MOB::MI
GGATCATCCCGTACGC-1	SS::L5
GGATCCGGAATATACT-1	CPu
GGATCTTGACTCAACC-1	MOB::Gr
GGATGAAGATCGCTGA-1	CPu
GGATGACGCGAGTTTA-1	MO::L5
GGATGGCTTGAAGTAT-1	Pal::NDB
GGATGTCCTTACCGCA-1	CPu
GGATTAATCATGGACC-1	OT::Ml
GGATTCCGCTATACCC-1	SS::L2/3
GGATTGCTGTGACTCC-1	Pal::Sl
GGATTTCACTTCTATA-1	CC
GGCAAAGGCGCCAATA-1	Ft
GGCAAATTACTTTACT-1	Cl
GGCAAGCCCATAGTGG-1	AON::L1_1
GGCAAGGCGAAATAGC-1	CPu
GGCAATAGTCAATGAG-1	MO::L6
GGCACGCTGCTACAGT-1	OT::Pl
GGCACTCCACTGGGCA-1	MO::L5
GGCACTGCGGTGGTTT-1	Pal::NDB
GGCAGCAAACCTATGC-1	Pal::GPi
GGCAGCGGTAATCCTA-1	SS::L2/3
GGCATACAGGTAGCGG-1	MO::L2/3
GGCATATCGGTTCTGC-1	SS::L2/3
GGCCAATTGTATAGAC-1	OT::Ml
GGCCCAGCTGGTTTGC-1	OT::Pl
GGCCCTCACCCACTTA-1	FRP::L1
GGCCGGCGTCTGCTAT-1	OT::PoL
GGCCGTTTGGGTTTCA-1	AON::L1_1
GGCCTGCTTCTCCCGA-1	HY::LPO
GGCGAAATCTAACTTG-1	CPu
GGCGAGCGAAACGGCA-1	MOB::Gr
GGCGCAGGACATCTTC-1	FRP::L2/3
GGCGCATGAATTGATG-1	Cl
GGCGCGGAGATCTTTC-1	AcbC
GGCGCGTTCGAGTTTA-1	Cl
GGCGCTTCATTCCCTG-1	OT::PoL
GGCGGAGTAATATTAG-1	MO::L5
GGCGGTAGGATCATTG-1	MO::L6
GGCGTAGGGAAAGCTG-1	AcbSh
GGCGTCCTATCCGCTG-1	MO::L2/3
GGCTAAAGGGCGGGTC-1	SS::L5
GGCTAATGATTGAAAT-1	SS::L1
GGCTATTAAGTTGTAT-1	MO::L2/3
GGCTCGCGTTGAGGTA-1	CC
GGCTCTGCTCCAACGC-1	MO::L5
GGCTGAAATAGCAAAG-1	CPu
GGCTTTCAATAAGGGT-1	AcbSh
GGGAAAGAATGCCAAC-1	Pal::NDB
GGGAACGGGAGGTTAG-1	MO::L5
GGGAAGACGGTCTGTC-1	AcbSh
GGGAAGGGCTTTCTCA-1	Pal::MA
GGGAATGAGCCCTCAC-1	SS::L5
GGGACAGAGTTACTCC-1	MOB::Opl
GGGACCCGTATATCTT-1	AON::L1_2
GGGACTGCATAGATAG-1	MO::L5
GGGAGAACTCACAGTA-1	MO::L6
GGGAGCGACCGTAGTG-1	OT::PoL
GGGAGGATGCCCGAAA-1	MO::L5
GGGAGTTAATGAGGCG-1	CC
GGGATGGTCGTAACCG-1	ORB::L5
GGGATTTACCGCACCT-1	CPu
GGGCAACCGCACGTGC-1	MOB::MI
GGGCACTATTGACCAT-1	MOB::Gl_1
GGGCAGACGTCACTGC-1	MOB::Gr
GGGCAGAGCAATCGTT-1	AcbC
GGGCAGTCAACGCCAA-1	OT::PoL
GGGCCCGTCTTAAACA-1	Cl
GGGCCGGCCGAAGTAC-1	CPu
GGGCCTAAATGGGCTA-1	MOB::Gr
GGGCGATATGTGTGAA-1	MO::L5
GGGCGGCAAATGAATT-1	ORB::L5
GGGCGGGTTCCCTACG-1	ORB::L5
GGGCGTACATTTATAT-1	MO::L2/3
GGGCGTCACCACGTAA-1	PIR
GGGCGTCCACTGGCTC-1	SS::L2/3
GGGCGTGGTTTCCCAG-1	AcbSh
GGGCTACTATTTCGTG-1	MOB::Gr
GGGCTATGATCGATGG-1	AON::L1_2
GGGCTCATCGAACCCA-1	SS::L5
GGGCTGCCTAGGGCGA-1	MO::L6
GGGCTGGTTAGTCGCG-1	MO::L5
GGGTACTTCATGAACT-1	MO::L5
GGGTATGTATGCACTT-1	MO::L1
GGGTATTCTAGCAAAC-1	MOB::Opl
GGGTCACCGTGACGGT-1	MO::L5
GGGTCAGGAGCTAGAT-1	AON::L1_1
GGGTCGTGGCAAGTGT-1	CC
GGGTCTATCGCTTTCC-1	HY::LPO
GGGTGACACCTTAACT-1	Cl
GGGTGCATATGAAAGC-1	SLu
GGGTTAACATTTGAGT-1	PIR
GGGTTTAGGATAGGAT-1	St
GGTAAACTCTGCGCTG-1	Pal::NDB
GGTAACCGGGAGGATA-1	MOB::MI
GGTACAAACATGCTAT-1	MO::L6
GGTACCATTAAGACGG-1	LV
GGTACGTTGCGGCCGG-1	Pal::NDB
GGTAGAAGACCGCCTG-1	AcbC
GGTAGACCGTTGGGCG-1	PIR
GGTAGTGCTCGCACCA-1	CC
GGTATAGTGACACATA-1	Or
GGTATTGCCGAGTTTA-1	MO::L5
GGTCAAGACTACTTCG-1	Pal::Sl
GGTCAGTGGGTCCCAC-1	Cl
GGTCGGATAAACGGCG-1	SS::L5
GGTCGGCCAGGAGCTT-1	CPu
GGTCGGTCGTCCACAG-1	AON::L1_2
GGTCGTAAGCTCGCAC-1	MOB::Gr
GGTCTCCGTCCAGGTT-1	Pal::MA
GGTCTCTGAATGGACT-1	Ft
GGTCTGAGAATCTGGA-1	MO::L6
GGTCTTGAGCGCTCTT-1	AON::L2
GGTGAAGTACAGGGAT-1	ORB::L2/3
GGTGATAAGGAGCAGT-1	CPu
GGTGCAGAGCCTATCG-1	SS::L1
GGTGCTGGTACACATT-1	ORB::L6
GGTGGACTGCTCTGGC-1	AcbC
GGTGTAAATCGATTGT-1	OT::Pl
GGTTACCACCCTCGGG-1	ORB::L2/3
GGTTAGCTATATGTCT-1	CPu
GGTTAGGCTTGGAGAA-1	MO::L2/3
GGTTCGGATTATACTA-1	MOB::Gl_2
GGTTCTACTCGTCTGA-1	Fim
GGTTTAATTGAGCAGG-1	Py
GGTTTACAATCTCAAT-1	MO::L5
GGTTTAGCCTTTCTTG-1	St
GGTTTCAATCGGTCAG-1	CPu
GGTTTGACAAGAAGCT-1	SS::L1
GGTTTGTGACCTGAGG-1	Pal::MA
GTAACATCTAAGATAA-1	HY::LPO
GTAAGCGGGCAGTCAG-1	MO::L2/3
GTAAGTAACAGTCTGG-1	CPu
GTAAGTAGGGTATACC-1	MO::L1
GTAATAAAGGGCTCCC-1	LV
GTAATCTGATTCTTCG-1	ORB::L2/3
GTACACTTACCTGAAG-1	CC
GTACAGAGGCAAGGGT-1	CPu
GTACGAGATTGCGACA-1	MO::L2/3
GTACGCTTCATTGCAC-1	CPu
GTACGTCACGTATTAA-1	SS::L1
GTACGTTTGCCCGTCA-1	CPu
GTACTAAGATTTGGAG-1	MO::L5
GTACTCCCTTATCGCT-1	MO::L2/3
GTACTCCTGGGTATGC-1	CC
GTACTGGAGTTAGACC-1	CPu
GTAGACACGCCTGACT-1	AcbSh
GTAGAGGGAGACAAGT-1	Ft
GTAGCCAAACATGGGA-1	CPu
GTAGCGGCTATACACT-1	CPu
GTAGCTTCCTCTTGTT-1	CC
GTAGGTGATCCGTGTA-1	SS::L2/3
GTAGTCGCGGGAATCA-1	CPu
GTAGTCTACGATATTG-1	AcbSh
GTAGTGAGCAACCTCA-1	Pal::NDB
GTATAGGACTCAGTAG-1	MO::L2/3
GTATCAAACGTTAGCT-1	Pal::Sl
GTATCCTTTGGTAACC-1	Pal::MA
GTATCTCAGTCTTGAC-1	MOB::Opl
GTATCTTTCATAACCA-1	CPu
GTATGAAATTTCACTC-1	MOB::Gr
GTATGTGGGTCTAGTT-1	CPu
GTATTCTGAGAAACGA-1	ORB::L2/3
GTCAAAGAAGTGGTGT-1	MOB::Opl
GTCAACCAGGCCTATA-1	Pal::MA
GTCAAGCGGACTCGGG-1	CPu
GTCAGAATAGTCTATG-1	MO::L2/3
GTCATGCACCTCCGTT-1	MO::L5
GTCATGCGCGAGGGCT-1	Pal::MA
GTCATGGACATGACTA-1	MO::L5
GTCATTAGAGCGAACG-1	CPu
GTCCAATATTTAGCCT-1	Io
GTCCATTACTGCTACG-1	St
GTCCCAACGTAAAGTA-1	CC
GTCCCAATCATCCCGC-1	MOB::Opl
GTCCCGCGACGTTATG-1	AcbC
GTCCGGACCTGAAATT-1	AcbC
GTCCGGCTGAATTGCG-1	MO::L5
GTCCGGGTTCACATTA-1	OT::Pl
GTCCTACGAATAGTCT-1	Pal::Sl
GTCCTACTCTACGGGC-1	MOB::Opl
GTCGCCGTTGTGTGTT-1	AON::L2
GTCGCGTAACCCGTTG-1	CPu
GTCGGAAGGATACCAG-1	SS::L2/3
GTCGGATATCTCAGAC-1	MO::L2/3
GTCGGATGTAGCGCGC-1	MO::L2/3
GTCGGGAACATGGTAG-1	MOB::Gl_2
GTCGGGAAGCAGAAAC-1	AcbSh
GTCGTACCATCTCGGG-1	CPu
GTCGTACCTACGATTG-1	MOB::Gl_2
GTCGTATTGGCGTACA-1	SS::L5
GTCGTGTCTGGTCATC-1	Or
GTCGTTATTCGCTTAT-1	CPu
GTCTAGTGAGCCGCTT-1	Pal::MA
GTCTATCTGAGTTTCT-1	ORB::L6
GTCTATTGCATGCTCG-1	Pal::MA
GTCTATTGGTTCCGGT-1	CPu
GTCTCAAGGCCCGGCT-1	AcbSh
GTCTCCCGAGTCCCGT-1	OT::Pl
GTCTCCTGCCAGTATG-1	MOB::Gl_1
GTCTCGACTAAGTTTG-1	CC
GTCTCGATCTGCTTTC-1	MO::L2/3
GTCTGGGCGGTCGAGA-1	ORB::L5
GTCTTACCACGCCAAG-1	OT::Ml
GTCTTGTAGCTATTCA-1	TH::RT
GTGAAACGGCGCCACC-1	SS::L5
GTGAACTCCCATTCGA-1	LV
GTGAAGATTTCAAGTG-1	SS::L5
GTGAAGCCGTATAGTC-1	SS::L5
GTGAAGTCACGACTCG-1	MOB::Gr
GTGACAGCTTCCCACT-1	AcbSh
GTGACCGCACACTACG-1	CPu
GTGACGAGGGTGACCC-1	SLu
GTGACGCAGGTTTCAT-1	OT::PoL
GTGACTTCAGTAGTGC-1	ORB::L6
GTGAGCGTGCTGCACT-1	MO::L1
GTGAGGACACTTAAGG-1	CPu
GTGAGGAGCGGTTGAG-1	SS::L1
GTGAGTCGACTAATAG-1	Pal::NDB
GTGAGTGGTACAACGC-1	PIR
GTGATCACTAACGCCT-1	Pal::GPi
GTGATCATAGATCTGC-1	Cl
GTGATCCTTGTCATGA-1	Pal::MA
GTGATGCACAACATCT-1	SS::L1
GTGATTCGCCGCTCAA-1	ORB::L2/3
GTGCACCAGCTTCAAC-1	Io
GTGCACGAAAGTGACT-1	MO::L1
GTGCCATCACACGGTG-1	ORB::L5
GTGCCCGTTCGGATTC-1	CPu
GTGCCGCTTCAAAGGT-1	ORB::L6
GTGCCTGAGACCAAAC-1	OT::Pl
GTGCGAAATCGAACAC-1	ORB::L5
GTGCGACAGGGAGTGT-1	CPu
GTGCGGGTCTCCAAAT-1	MO::L1
GTGCGTGTATATGAGC-1	CPu
GTGCTCAAGTACTGTC-1	MO::L5
GTGGAACCTACATGCG-1	SS::L1
GTGGACCAACCCGATT-1	ORB::L2/3
GTGGACGCATTTGTCC-1	AcbC
GTGGAGCGTTTACCGA-1	MOB::Opl
GTGGAGTCGGCGGTTG-1	AOE
GTGGCAAACAGCGGCA-1	MOB::Gr
GTGGCGGTCCCAGCGT-1	ORB::L1
GTGGCTGTTTCTGTTC-1	OT::Pl
GTGGGAAGACTGAATC-1	AOB::Gr
GTGGGCTTAGACACAC-1	MO::L2/3
GTGGGTACTGAGCGTA-1	MOB::Gr
GTGGTATAGTCTGCCG-1	AON::L2
GTGGTGGCCAAGTGAA-1	CPu
GTGGTTACTTCTTTCG-1	LV
GTGGTTTCCGCCTTTC-1	ORB::L5
GTGTACCTTGGCTACG-1	MO::L5
GTGTATATCAGCGGGC-1	AcbC
GTGTCGTATAGCGTTC-1	AcbC
GTGTGAATAACTTAGG-1	CPu
GTGTTACTATGCGTCC-1	CPu
GTTAAAGTAGGACTGG-1	CPu
GTTAACATCACTTAAA-1	AcbC
GTTAACTATGTTGTCA-1	TH::RT
GTTAAGGGTGCGATGT-1	AcbSh
GTTACAATTGGTGACG-1	FRP::L2/3
GTTACCTACAACTTGC-1	CPu
GTTACTTTGGGCCTAG-1	Cl
GTTAGCCCATGACATC-1	OT::PoL
GTTAGCCGTAAATCAA-1	Py
GTTAGGCTACCCGTTT-1	MOB::MI
GTTATAATACGGTGAA-1	Pal::Sl
GTTATATCAGGAGCCA-1	CC
GTTATATTATCTCCCT-1	Cl
GTTATCAAGCTATCGA-1	Pal::NDB
GTTCACAGGAGTCTAG-1	MO::L2/3
GTTCATCGTTTGGCTG-1	LV
GTTCGCCATAAGTGCC-1	MO::L6
GTTCGCTGAGACGTCT-1	TH::RT
GTTCGGATCGGGAACA-1	TH::RT
GTTCGGGCGTACCATT-1	Or
GTTCGTCTAAAGAACT-1	CPu
GTTGAACCGGTTCCAT-1	ORB::L5
GTTGAGTCCCGCCGGT-1	AcbC
GTTGCACGGAGTTTCG-1	MO::L2/3
GTTGGACCGCATCAGG-1	SS::L6
GTTGGATTCAGTGGCT-1	SS::L2/3
GTTGGATTGAGAACAC-1	CPu
GTTGGATTTGCGTTGG-1	MO::L5
GTTGGTCATGCTATCC-1	AcbC
GTTTACGTTCCATCTG-1	CC
GTTTCAAACGAGTTGT-1	HY::LPO
GTTTCATATCGTCGCT-1	FRP::L2/3
GTTTCCTGGAGGGTGA-1	MO::L2/3
GTTTCTAGAGGCGCGG-1	Pal::NDB
GTTTCTGCAGTCTCCC-1	CPu
GTTTGACCAAATCCTA-1	MO::L5
GTTTGGCCCAAGTTAT-1	CPu
GTTTGGGCTTGTGAGC-1	Cl
GTTTGGGTTTCGCCCG-1	Pal::MA
GTTTGGTAGGGTCAAC-1	PIR
GTTTGTTAGCCAAGTA-1	MOB::lpl
TAAACCCAGGAGGGCA-1	AOE
TAAAGCGGTATTTCCA-1	Io
TAAAGCGTTAGGAGAA-1	MO::L6
TAAAGCTGCAATAGGG-1	SS::L5
TAAATGCCGTCTCATG-1	SS::L1
TAACATACAATGTGGG-1	CPu
TAACATACACGCGATC-1	MOB::Gr
TAACCTACCGTCCGAG-1	CPu
TAACCTAGGGAGTCCA-1	HY::LPO
TAACTATTACGCCAAA-1	Or
TAACTCATCCGCGCGG-1	ORB::L6
TAAGAGGGACAGGGAC-1	MOB::Gl_1
TAAGCCCTTACGACCA-1	SS::L2/3
TAAGGCAACATAAGAT-1	MO::L5
TAAGGCATAACATCAA-1	AON::L1_2
TAAGGCCCGTCACCCT-1	AcbSh
TAAGGCTGAATCCCTC-1	St
TAAGGGCCTGTCCGAT-1	Pal::Sl
TAAGTAACATCTTGAC-1	ORB::L5
TAAGTCGCCGAGTATC-1	Ft
TAAGTTGCGACGTAGG-1	Pal::Sl
TAATAAACAAGGAGAT-1	SS::L2/3
TAATACACAGTAGTAT-1	MO::L2/3
TAATACTAGAACAGAC-1	OT::PoL
TAATAGAACAGAGTTA-1	ORB::L2/3
TAATAGGTCACCAGAA-1	MOB::Gl_1
TAATAGTGACGACCAG-1	MO::L5
TAATCGATCCGTACGT-1	SS::L5
TAATTACGTCAGTAGA-1	Pal::MA
TAATTAGGACATCCGT-1	St
TAATTGGAATCGGGAA-1	SS::L5
TAATTTCCGTCCAGTA-1	MOB::Gl_2
TACAACAGCGCATACA-1	OT::Ml
TACAACGCACAACTCA-1	MO::L6
TACAAGGGCTTCTTTA-1	Pal::NDB
TACAAGTCTCGTGCAT-1	MO::L1
TACACAGCCGTGGTGC-1	OT::Ml
TACACCTCTTCGAATC-1	OT::Ml
TACAGAAACGGTGGGC-1	AcbC
TACATAGGCATACACC-1	CC
TACATCCCTATCCCTG-1	MOB::Gr
TACATTTCTAACGTGC-1	MO::L6
TACCAAATAGCCCAGA-1	AcbSh
TACCAATAAAGTACCA-1	AcbC
TACCAGAAGTAGGTTC-1	PIR
TACCGAATAATTGTAA-1	Pal::NDB
TACCGCGGACTTGCAG-1	CPu
TACCGGCTCACTGCCC-1	CPu
TACCGGTCGTTTCCAT-1	ORB::L2/3
TACCGTAGGTTAACTA-1	En
TACCGTGCCTCGGACC-1	CPu
TACCTACTCCCAGTAT-1	AcbC
TACCTATCCCTAGAGG-1	MOB::Gl_2
TACCTCAGTTGTCTGT-1	AON::L2
TACCTTAAGATTTCCC-1	AOB::Gl
TACGAACACGACTTCA-1	MO::L5
TACGACGCTTGCTGCG-1	Cl
TACGACTGCCTCTTAG-1	CPu
TACGAGAACTTCACGT-1	MO::L2/3
TACGATGTTGATCATC-1	MO::L2/3
TACGCAGTTCTTTCCT-1	Cl
TACGCCATATTCTAAT-1	CC
TACGCCGAGGGTACCC-1	Ft
TACGCCTCCATTCCGA-1	En
TACGCTATAGAAACCT-1	LV
TACGCTCGGTATTGGA-1	HY::LPO
TACGGAAGCCAAACCA-1	OT::Pl
TACGGGATGCTAGCAG-1	SS::L5
TACGGGTAATAACATA-1	OT::Ml
TACGTAAAGCGGAGTG-1	Pal::MA
TACGTGGGCCCAGGGC-1	OT::Pl
TACGTTTACCGGCAAT-1	FRP::L2/3
TACTACGTGCAATGCG-1	OT::Ml
TACTATGGTTCCTCAG-1	AON::L1_2
TACTCGGCACGCCGGG-1	Not_annotated
TACTCGTTTGAATCAA-1	OT::Ml
TACTCTCCGAACAAAT-1	MO::L5
TACTCTTACTTTACTG-1	HY::LPO
TACTCTTTCGTCTTCA-1	AON::L2
TACTGAACAGATTTAG-1	AON::L1_2
TACTGAGGGAAGAAAG-1	MOB::Gl_1
TACTGCAATCAATTAC-1	SS::L5
TACTGGACAGCTCGGC-1	MO::L1
TACTTAAACATGTACA-1	Pal::NDB
TACTTGTTAGTAGTCC-1	CPu
TACTTTACTGAGCCGG-1	CC
TACTTTCCGCACGCCA-1	AOB::Gr
TAGAAAGGTGGCGCTA-1	CC
TAGAATAGCCGATGAA-1	Pal::MA
TAGACGAAACGCCAAT-1	AcbSh
TAGACGCCCGTACCGG-1	CPu
TAGACTACCTAGCGTT-1	LV
TAGAGATCATGCAACT-1	ORB::L1
TAGAGGTTCTACTTGT-1	Pal::Sl
TAGAGTCTAAGCGAAC-1	MO::L5
TAGATATGGACTGGAA-1	PIR
TAGATGGTTCCTTACT-1	Pal::Sl
TAGCAGATACTTAGGG-1	OT::Ml
TAGCAGTATGACTAAA-1	Pal::MA
TAGCCATTTCAAAGTC-1	CPu
TAGCCGGCGGTCAGCG-1	CPu
TAGCGTCCCTCGATTG-1	TH::RT
TAGCGTCCGGTGTGGT-1	AcbC
TAGCGTTGGGTCTTAC-1	CPu
TAGCTAAGTCCGGGAG-1	MO::L5
TAGCTAGAAGGCATGA-1	PIR
TAGCTAGTGATGATGG-1	AON::L1_1
TAGCTCGCCTGATAAC-1	PIR
TAGCTGATGTGAAGCG-1	MOB::Gr
TAGGAGGCTCGAGAAC-1	OT::Pl
TAGGCATGTTACGCCA-1	SS::L5
TAGGCCTATATAGTCT-1	Pal::NDB
TAGGCGATGAGGTCTC-1	MOB::Opl
TAGGCTAAAGTGGCAC-1	Pal::MA
TAGGGAGCTTGGGATG-1	CPu
TAGGGTGTTTCAAGAG-1	MO::L2/3
TAGGTCGCCGGAACTG-1	LV
TAGGTGACGATAACCT-1	AcbSh
TAGGTGAGCCCTACTC-1	MO::L2/3
TAGGTGCTCGCCTAGC-1	CPu
TAGGTGTTCCACAGAT-1	En
TAGGTTCGAGTTCGTC-1	CC
TAGTACCACAACTTTC-1	MOB::Gl_1
TAGTAGCTTATACCAG-1	Io
TAGTCCGCAGAGAATG-1	MO::L6
TAGTCGATCACGGGTT-1	Pal::GPi
TAGTCTAACAACGAGA-1	FRP::L2/3
TAGTCTGTGACGTTGC-1	SS::L6
TAGTGCCCTCCAGAGT-1	MO::L5
TATACACAGACGCCTT-1	Cl
TATACGCGTCATCACT-1	AcbSh
TATAGATGGTCGCAGT-1	St
TATAGCGCACGTTATC-1	MOB::Gr
TATATATCGAGAAATG-1	MOB::Opl
TATATCCCTGGGAGGA-1	CPu
TATATTACAAATGTCG-1	SS::L5
TATCACCCAACCGACC-1	SS::L6
TATCACTTCGAGTAAC-1	SS::L5
TATCAGTGGCGTAGTC-1	MOB::Opl
TATCCAATTGGTTATC-1	AcbC
TATCCATCTCGGTTAG-1	MOB::Gl_1
TATCCGCACCGTCGGG-1	AON::L1_2
TATCGATCTATGCATA-1	SS::L5
TATCGATGATTAAACG-1	MO::L2/3
TATCTACCACAGCGGG-1	CPu
TATCTGAGCCGATATT-1	MOB::Gl_1
TATCTTGCAATACAAC-1	MOB::Opl
TATGAAGAATTAAGGT-1	Pal::NDB
TATGACCTTGCGCTGG-1	MOB::Gr
TATGATCCGGCACGCC-1	Or
TATGATCTTCTCTTTA-1	Pal::Sl
TATGCTCCCTACTTAC-1	MO::L5
TATGGATGTGCTACGC-1	MO::L5
TATGGCCCGGCCTCGC-1	MO::L1
TATGGGACCGAGCAGG-1	MO::L5
TATGGGTACGTATCGT-1	MO::L5
TATGGTCTGAGTAACA-1	MO::L6
TATGGTTAGTGGGAGA-1	St
TATGTAGAAACCCGGC-1	MOB::Gl_1
TATGTCAAGACCGACT-1	SS::L5
TATGTCTCATTGTGCC-1	MO::L6
TATTAACACCAAAGCA-1	MOB::Opl
TATTAACCTGACCGCG-1	AON::L2
TATTACCATCCTGCTT-1	CPu
TATTATGTTTGCCTGC-1	MOB::Opl
TATTCAATTCTAATCC-1	CC
TATTCCACTCAGCTCG-1	PIR
TATTCCGAGCTGTTAT-1	AcbC
TATTCCTCCGCCCACT-1	ORB::L2/3
TATTCGTGCCAGAATA-1	MO::L6
TATTGCCGGGCTTGTA-1	Pal::NDB
TATTTAGTCTAGATCG-1	MO::L1
TATTTATACCGAGTAG-1	SS::L1
TATTTGTTACCCTTTA-1	MO::L2/3
TCAAACAACCGCGTCG-1	MO::L2/3
TCAAACTTAGATTGTT-1	MO::L5
TCAAAGAGCTATCTGT-1	MOB::Gr
TCAAATTGTTGTGCCG-1	OT::PoL
TCAAATTTGAGACTCA-1	AcbSh
TCAACAAAGATAATTC-1	AOB::Gr
TCAACATAGCGCCCTA-1	AON::L1_1
TCAACATCGACCGAGA-1	AOB::Gr
TCAACCATGTTCGGGC-1	MO::L2/3
TCAACGAGGAGACAAA-1	Cl
TCAACGCAGGAAATAA-1	ORB::L1
TCAACGCGACCGGCAG-1	FRP::L1
TCAACTGCAGAGTCAG-1	Pal::Sl
TCAAGAAATACTAGCT-1	Or
TCAAGCGCGGACGGTA-1	HY::LPO
TCAAGGTTACTACACC-1	Pal::GPi
TCAATACGCCGTCATG-1	En
TCAATCCGGGAAGTTT-1	OT::Ml
TCACAAACCGAGGTAC-1	Pal::Sl
TCACAGCAAACTCGAA-1	PIR
TCACAGGAGAATAAGA-1	PIR
TCACAGGGAATCGCAA-1	CPu
TCACAGGTTATTGGGC-1	MO::L5
TCACCCTCTTAAGATT-1	CC
TCACCGCTCGGCACTC-1	CC
TCACGATGTCCGTGGA-1	AOB::Gr
TCACGCATTGTAGATC-1	MO::L5
TCACGGTCATCGCACA-1	MO::L1
TCACGTGCCCGATTCA-1	CC
TCACTACGACCAATGC-1	SS::L2/3
TCACTATCCCTTCGGT-1	OT::Pl
TCACTCGTGCAACGGC-1	SS::L2/3
TCAGAACCTCCACAGG-1	LV
TCAGACGCTATAGAAG-1	CPu
TCAGCAAATGCATCTC-1	MO::L6
TCAGCCAATCCGTAAA-1	Pal::MA
TCAGCTTGAGCTTTCG-1	MOB::Gl_1
TCAGGGTGTAACGTAA-1	MO::L5
TCAGGTTCTTTGAGAA-1	MO::L2/3
TCAGTACTGACCCGCG-1	MO::L1
TCAGTAGGGACTATAA-1	ORB::L6
TCAGTGTATACGTCAT-1	AOE
TCATATGAGCTTTGTT-1	AON::L2
TCATCCTCAGCTGCTT-1	Pal::NDB
TCATCGACGACCGTCG-1	OT::Pl
TCATCGATGGTCCCAA-1	MOB::MI
TCATGCAGGTTCTCAT-1	SS::L2/3
TCATTTAAGTCTCCGA-1	CPu
TCATTTAGAAGTGTGA-1	Pal::Sl
TCCAACTCAGCTATCT-1	Pal::MA
TCCAACTTTAAATTCT-1	ORB::L5
TCCAAGCCTAGACACA-1	OT::PoL
TCCAATAAAGGCTACC-1	AON::L1_1
TCCACAATGGTTTACG-1	MO::L2/3
TCCACCAAGACATAGG-1	OT::Pl
TCCACCTCTAGCCTTT-1	AON::L2
TCCACTTTATCTAGGT-1	MO::L6
TCCAGAGCACCGGTTC-1	CPu
TCCAGATGTACGCCAA-1	Or
TCCAGGCGAGTACGGT-1	MO::L5
TCCAGGGTATATACGA-1	AcbSh
TCCATCAATACTAATC-1	MOB::Gl_1
TCCCAAACAGACAACG-1	SS::L6
TCCCAAAGACGAAGGA-1	MO::L5
TCCCACTCTCTTCCGG-1	Or
TCCCAGCTTTAGTCTG-1	MO::L5
TCCCAGGCTTAGCTAA-1	MO::L5
TCCCGCGTACTCCTGG-1	MO::L5
TCCCGGGTGTGCTGCT-1	MO::L2/3
TCCCGTCAGTCCCGCA-1	MO::L5
TCCCGTCGCGTCATAG-1	SLu
TCCCGTGTGCAATTTG-1	CPu
TCCCTAGATCAATAGG-1	SLu
TCCCTGGCGTATTAAC-1	MOB::Opl
TCCCTGGCTCGCTGGA-1	MO::L1
TCCCTTAGATTACTCG-1	SS::L2/3
TCCGAAGTAGTCACCA-1	SS::L2/3
TCCGAATGGTCCTGAG-1	SLu
TCCGATAATTGCCATA-1	MO::L1
TCCGATGACTGAGCTC-1	MO::L5
TCCGATGGTGCGACAT-1	MO::L2/3
TCCGATTACATTGCCG-1	MO::L2/3
TCCGCCTGTCTACAAG-1	AcbC
TCCGCGGCAGCATCTG-1	CPu
TCCGCGGCCCAATGAA-1	Pal::Sl
TCCGCTGTCATCCCGG-1	CPu
TCCGCTTATCCCATTA-1	Cl
TCCGGAGGAAGGGCTG-1	SS::L2/3
TCCGGCCTAGCGTACA-1	CC
TCCGGGCTTGACGGGA-1	Pal::MA
TCCGGTTCGTCCGGTC-1	PIR
TCCGTTAAGCTAATAT-1	Pal::GPi
TCCGTTTAGCCTTGAA-1	MO::L6
TCCTAAAGATTCAGAC-1	OT::PoL
TCCTAAATTGGGAAGC-1	AcbC
TCCTAACCGTCGGGCA-1	Io
TCCTACATCCACGGCC-1	CPu
TCCTAGCAAAGAAGCT-1	ORB::L6
TCCTCCTAAGACATTC-1	AOB::Ml
TCCTCGGGCTGGGCTT-1	CPu
TCCTCTACGAGATGGC-1	MO::L1
TCCTGCCAACTGGAGA-1	SS::L1
TCCTGCGTTGATACTC-1	FRP::L2/3
TCCTGGCGCTGCCTGG-1	SS::L1
TCCTTACGACGGTCCG-1	Pal::GPi
TCCTTCAATCCCTACG-1	MOB::Opl
TCCTTGTCCTTTAATT-1	OT::Pl
TCCTTTAAATCCGCTT-1	Pal::Sl
TCCTTTCTTACGCTTA-1	MO::L5
TCGAAATTTAGGACCA-1	MO::L2/3
TCGAAGAACCGAGCAC-1	St
TCGAATATCCCGCAGG-1	MOB::lpl
TCGACAACTGAACCCG-1	MOB::Opl
TCGAGACCAACACCGT-1	MO::L6
TCGAGTCTACGATTCG-1	MOB::Opl
TCGCAAAGATGCATTT-1	CPu
TCGCACCAGGAGGCAG-1	CPu
TCGCATAAAGGGCGCA-1	HY::LPO
TCGCCGAAGTTGCGTC-1	ORB::L5
TCGCCGACATATTCGC-1	OT::PoL
TCGCCGCACCGCGTGA-1	MOB::Gr
TCGCCGGTCGATCCGT-1	MO::L1
TCGCGTAGCAGTGTCC-1	Pal::Sl
TCGCGTCCAGAAGGTC-1	MO::L1
TCGCTAAACCGCTATC-1	SS::L5
TCGCTACTGGCTTTGA-1	AcbSh
TCGCTCGATATATTCC-1	MO::L5
TCGCTCGGCACCAGCG-1	SS::L6
TCGCTGCCAATGCTGT-1	OT::PoL
TCGCTGGGCGGATTGT-1	MO::L5
TCGCTTTAAACGTTTG-1	SS::L5
TCGGAATGCGCTCTGA-1	MO::L1
TCGGACGCCCAGCCCA-1	CC
TCGGAGAGTATCGGGA-1	AOB::Gl
TCGGAGTACATGAGTA-1	MO::L6
TCGGCGAACCCAAACC-1	TH::RT
TCGGCGTACTGCACAA-1	MOB::Gr
TCGGCTTGTATCGACG-1	Pal::Sl
TCGGGAACGTGCCTAG-1	Or
TCGGGAGACAGCGTAC-1	AcbC
TCGGGCCGTCGTGGTA-1	CPu
TCGGTCCCGACAATAG-1	MOB::Opl
TCGGTGACCGCTCCGG-1	SS::L2/3
TCGTAAGACGACATTG-1	MO::L5
TCGTAAGCTCCGAGGA-1	SS::L5
TCGTACCGACGTCAAG-1	Io
TCGTATTACCCATTGC-1	FRP::L1
TCGTCAAGTACGCGCA-1	AOE
TCGTCTTAGGCGTTAA-1	AcbC
TCGTGTACTATGGATG-1	CPu
TCGTGTCACGCTGACA-1	ORB::L1
TCGTGTTCGACCACAA-1	Pal::Sl
TCGTTAGGAGTCCCTA-1	PIR
TCGTTGCTATCCGGTC-1	AOE
TCGTTTACGCGACCCT-1	OT::Pl
TCTAAAGAACAGTCTC-1	MOB::Gr
TCTAACCTAGCCTGCG-1	OT::Ml
TCTAATACTGCCTCAG-1	MOB::Opl
TCTACCCAATAGAGAG-1	Pal::Sl
TCTACCCGCATCATTT-1	OT::Ml
TCTACCGTCCACAAGC-1	MO::L5
TCTAGCAATCTCCGCC-1	ORB::L1
TCTAGCATCTTCGATG-1	MO::L1
TCTAGCATGCCCAGAA-1	CC
TCTAGGTGGCGACGCT-1	CC
TCTAGTGATATCGTGG-1	St
TCTAGTTATCAGAAGA-1	MO::L5
TCTATAGGTGGGTAAT-1	Pal::MA
TCTATCGGTCGCAACA-1	MO::L2/3
TCTATGCTATAACGAC-1	Pal::MA
TCTATTACTAGAGGAT-1	MOB::MI
TCTCAAATCAATCGGG-1	OT::Ml
TCTCATGAGATAGGGT-1	CPu
TCTCCAACGTAGGTTA-1	MO::L2/3
TCTCCACAAGTTGAAT-1	Pal::Sl
TCTCCCTGGGCAGCGT-1	AcbC
TCTCGAACGAGGTCAC-1	SS::L1
TCTCGACGTATCGCCG-1	TH::RT
TCTCGAGGAGGTTCGC-1	TH::RT
TCTCGTGTTACGAGGA-1	MOB::Gr
TCTCTAATAGCTGGTA-1	MO::L1
TCTGAACTCGTACCCG-1	Pal::GPi
TCTGAAGCACGTGGTC-1	AcbC
TCTGAATTCCGTACAA-1	CPu
TCTGAGCAATTGACTG-1	TH::RT
TCTGATGTATTCTGTC-1	CPu
TCTGCATACCTTGCTT-1	Pal::MA
TCTGCCAGAAACTGCA-1	CPu
TCTGGGAACCTTTGAA-1	CPu
TCTGGGTAGCGCTCAT-1	ORB::L5
TCTGTGCCATCATAGT-1	CC
TCTGTTACCCAGCATA-1	ORB::L1
TCTTACCGGAACTCGT-1	SS::L5
TCTTACTTATGCCTCT-1	CPu
TCTTAGAGCTCCAATT-1	Fim
TCTTAGAGTGAACTCT-1	St
TCTTCCCATGGGCACA-1	CPu
TCTTCGAATAGACGTT-1	CPu
TCTTCGATACCAATAA-1	MO::L6
TCTTCTATAACCCGCC-1	TH::RT
TCTTGATGCGTAGCGA-1	MO::L6
TCTTGCTCCCGATACT-1	En
TCTTGGTAACACCAAA-1	MO::L2/3
TCTTTAAGACTATGAA-1	CPu
TCTTTAGAGTCTAACA-1	TH::RT
TGAAAGGACCTGACTC-1	CPu
TGAACTGCTATGACTT-1	MOB::Gl_2
TGAATACCGACGCGTA-1	OT::PoL
TGAATATGCTATAAAC-1	SS::L5
TGAATGTCAGCCGGCC-1	TH::RT
TGAATTTCACTTGCCT-1	MOB::MI
TGACACTTCTCTTTGC-1	SS::L2/3
TGACAGGACAAGTCCA-1	MOB::Opl
TGACATATATGACGAT-1	MOB::Gl_2
TGACATCGAGCGGACC-1	CPu
TGACATGTAACGTGAC-1	OT::Pl
TGACCAAATCTTAAAC-1	AON::L1_1
TGACCCACGTTAGACA-1	MO::L5
TGACGAATATTTCCCT-1	AOB::Gl
TGACGATGCACTAGAA-1	CPu
TGACTATAATCCTTTC-1	CPu
TGACTCCGAATCATAC-1	MOB::Gl_1
TGAGACGTACCTCTCA-1	MOB::Gl_2
TGAGAGATTTACCACG-1	CPu
TGAGATTAGGCCCTAA-1	SS::L2/3
TGAGCCATACAGTCTC-1	ORB::L5
TGAGCGGAAAGTGTTC-1	AcbC
TGAGCTTTAATGACGC-1	SS::L2/3
TGAGGAGTGCCAGCTT-1	En
TGAGGCATGTACTGTG-1	MOB::Opl
TGAGTAAATTAGCGTA-1	Cl
TGAGTGCCTCTTAAAT-1	ORB::L5
TGAGTGGTCCGTGACG-1	CC
TGAGTGTAACAACGGG-1	OT::Ml
TGAGTTAAAGACATTC-1	TH::RT
TGATACATTTAGCCGT-1	AON::L1_2
TGATCAGGGAACTGCT-1	ORB::L1
TGATCCCAGCATTAGT-1	CC
TGATCGGTTTGACCCT-1	MO::L5
TGATCTACGCTGATCT-1	SS::L2/3
TGATCTATCACACTCT-1	OT::Ml
TGATCTCCGGCGCCAG-1	MO::L2/3
TGATGGCTGTTTCTGA-1	SLu
TGATGTCAATTAAGTG-1	Pal::Sl
TGATTATGGCACGCAG-1	SS::L2/3
TGATTCAGGTCCCGCG-1	MOB::Gr
TGATTCCCGGTTACCT-1	Io
TGATTCGTCTATCACT-1	MO::L2/3
TGATTCTGTCGCCGGT-1	ORB::L5
TGATTTATTAGCTGTG-1	FRP::L2/3
TGCAACCCATCTGCGG-1	Pal::Sl
TGCAACTACTGGTTGA-1	OT::Pl
TGCAAGAATGACGTAA-1	MO::L5
TGCAATCTAACACGGT-1	Pal::MA
TGCAATTTGGGCACGG-1	SS::L2/3
TGCACAGTGAAGTTAT-1	SS::L1
TGCAGAACTATATCGT-1	ORB::L1
TGCAGAGTACCGAGCA-1	MO::L5
TGCAGATCGTCCTAGG-1	MOB::Opl
TGCAGCTACGTACTTC-1	MOB::Gr
TGCAGGATCGGCAAAG-1	MO::L5
TGCAGTTTCCTCCCAT-1	CPu
TGCATATGTCTGTCAC-1	CPu
TGCATGGATCGGATCT-1	MO::L2/3
TGCATGTGGTAATCTA-1	MO::L6
TGCCAAAGTCAGACTT-1	AOB::Gl
TGCCAATGGGTACTCT-1	PIR
TGCCACACTAGAGGAA-1	MOB::lpl
TGCCACCTGGCGAAAC-1	MO::L2/3
TGCCAGTACGTGGAGA-1	CPu
TGCCATTACTAAAGAA-1	SS::L5
TGCCCGATAGTTAGAA-1	OT::Ml
TGCCCGTACCGTTAAA-1	CPu
TGCCGTGGATCGTCCT-1	AcbC
TGCCGTGGGACCCAAT-1	OT::Ml
TGCCGTTCTTAATCGG-1	MOB::Gl_1
TGCCTAATTGAAGATT-1	Pal::Sl
TGCCTGATCAAACGAT-1	MO::L2/3
TGCCTTGGCCAGGCAA-1	CPu
TGCGAATATGGGATTT-1	MOB::Gr
TGCGACACCCTAGTGC-1	ORB::L5
TGCGAGAATATTACCC-1	ORB::L2/3
TGCGAGATGGCGGCCA-1	SS::L1
TGCGAGCCCTTCCGCG-1	SS::L1
TGCGCAAAGCATTTGG-1	MO::L6
TGCGCGATTAACGGAG-1	MO::L2/3
TGCGGACTTGACTCCG-1	OT::PoL
TGCGGAGTAAAGGTGC-1	MO::L2/3
TGCGTAAGAACCTGAT-1	ORB::L6
TGCGTACGGCTAATTG-1	Pal::NDB
TGCGTCATGACTGAGC-1	MOB::Gr
TGCGTTTGTTGACACT-1	CPu
TGCTAAGTGTCTATTT-1	AcbC
TGCTCCACAGTTCTTA-1	CPu
TGCTCGGCGAAACCCA-1	AcbC
TGCTCGGTGGGTCACC-1	OT::PoL
TGCTCTTGAGAGTTTG-1	AcbSh
TGCTGTTGAAGAACTC-1	CPu
TGCTTCCCAAGCAGTA-1	AcbSh
TGGAACCACTGACACA-1	SS::L6
TGGAAGAAGGGAACGT-1	FRP::L2/3
TGGAAGGATAAAGATG-1	MO::L2/3
TGGAATATCCTTGACC-1	SS::L6
TGGACCAATCTAAGAT-1	AcbSh
TGGACGCAATCCAGCC-1	MOB::Opl
TGGACTGTTCGCTCAA-1	CPu
TGGAGTGATGCGATGA-1	MO::L2/3
TGGCAAACTAAATTAC-1	CPu
TGGCAACTCGCGCGCC-1	SS::L5
TGGCAAGCACAAGTCG-1	Io
TGGCAATGGGACGGCG-1	Pal::Sl
TGGCAGATTACGATCA-1	CC
TGGCAGCAGTAATAGT-1	CC
TGGCATGAAGTTTGGG-1	MOB::Opl
TGGCCAAACTGAAGTA-1	MO::L6
TGGCCAATTTGGTACT-1	MOB::Gr
TGGCCGTATATTGACC-1	MO::L1
TGGCGACTGCTCCAAA-1	AON::L1_2
TGGCGATCAAGTTATG-1	PIR
TGGCTACACTCTACCT-1	Pal::MA
TGGCTATGTGACATAC-1	AcbC
TGGCTCTTGTCGCGTA-1	MOB::Gr
TGGCTTATGTATAATG-1	MOB::Gl_1
TGGCTTGTACAAGCTT-1	SS::L5
TGGGATGCACTCATTC-1	SS::L1
TGGGCAATAGTTGGGT-1	TH::RT
TGGGCCACAAGAGCGC-1	MO::L2/3
TGGGCCCATACTAATT-1	CPu
TGGGCGATACAATAAG-1	OT::Ml
TGGGTGCACAAGCCAT-1	OT::Pl
TGGGTGGGATGTCATT-1	SS::L1
TGGGTGTAATAGATTT-1	Pal::NDB
TGGTAAGCAGGATTGA-1	MOB::MI
TGGTAGAATATATGGG-1	Pal::GPi
TGGTCCCACGCTACGG-1	AcbC
TGGTCGTGCAAGGCAA-1	MOB::Opl
TGGTCTGTTGGGCGTA-1	FRP::L2/3
TGGTTAACTTACATTT-1	MOB::Gl_1
TGGTTAAGGGCGCTGG-1	Or
TGGTTCAACGGGTAAT-1	CPu
TGGTTCGTAGCAAAGG-1	MO::L2/3
TGGTTTAAACGTGGGT-1	CC
TGTACCTACACGAGGG-1	Pal::Sl
TGTACGAACAAATCCG-1	MO::L6
TGTACTTCCGGGCATG-1	Pal::NDB
TGTAGCCAATTCCGTT-1	OT::Pl
TGTAGCCATCCCATTC-1	HY::LPO
TGTAGGAGAAATTTCC-1	CPu
TGTAGTGATCTATAAT-1	MO::L2/3
TGTATAACAGATCCTG-1	MO::L6
TGTATCAGACTGAAGC-1	SS::L1
TGTATGGCGCAGACAG-1	CPu
TGTCATTTGTTGGGAA-1	SS::L6
TGTCCACGGCTCAACT-1	Pal::MA
TGTCCTAAGTCACCGC-1	MO::L2/3
TGTCGTTATCACATAT-1	MOB::Gl_1
TGTGACTACGCCAGTC-1	MO::L2/3
TGTGACTAGAGTTTGC-1	Pal::NDB
TGTGAGACTAGCCCAA-1	AcbSh
TGTGCCAGAGGCAAAG-1	MOB::Gl_1
TGTGCCGGTGCCGGAA-1	Pal::Sl
TGTGGCAAAGCGTATG-1	MO::L6
TGTGGCGGGCTTCTGG-1	AON::L2
TGTGTCGAAGTCGAGG-1	MOB::Opl
TGTGTGACCATGAATC-1	MOB::Gr
TGTTATTGTATGTGGC-1	CPu
TGTTCCGCTTCCATGA-1	MO::L5
TGTTCCGGCCTGAGCT-1	OT::Ml
TGTTCGTATTGCGGTG-1	Cl
TGTTCTTCCATTGACT-1	MO::L5
TGTTGTCAAGAAGTCT-1	MO::L5
TGTTTCTGAAGCGTGC-1	MOB::Gl_1
TGTTTGAGATCGTCAG-1	TH::RT
TTAAACTCGAATTCAT-1	CC
TTAAAGTAAGTCGCCA-1	Pal::NDB
TTAACCAACCCTCCCT-1	MO::L1
TTAACGAACAAGCAGT-1	SS::L6
TTAACTTCAGGTAGGA-1	AOB::Gl
TTAAGATAGGATTGAC-1	St
TTAAGCGCCTGACCCA-1	MO::L2/3
TTAAGGCCCGTACTTT-1	MOB::Opl
TTAAGTATTGTTATCC-1	Pal::MA
TTAATCAGTACGTCAG-1	MO::L2/3
TTAATGTAGACCAGGT-1	MO::L6
TTAATTGCTTTGGGTG-1	AcbSh
TTAATTTCAGACGCGG-1	MO::L1
TTACAACTACGCATCC-1	MO::L2/3
TTACACGATCTGCGAC-1	HY::LPO
TTACAGACCTAAATGA-1	SS::L6
TTACATGCCACAACTA-1	St
TTACCATTGATTACCC-1	MO::L2/3
TTACCCATTGCCGGGT-1	SS::L2/3
TTACCCTAGGGATTGG-1	En
TTACGGATGGTTCGAG-1	CPu
TTACTAAAGGACTTTA-1	CPu
TTACTCCGGCCGGGAA-1	CPu
TTACTCTGGTACGTAC-1	ORB::L2/3
TTACTGGGATATTTCA-1	Cl
TTACTGTCTAGAGCTC-1	SS::L5
TTAGAAGAACATGACT-1	Cl
TTAGAATAAGGGTCGG-1	Io
TTAGACACGATCGTTG-1	SS::L2/3
TTAGACGAGTCACCTC-1	CPu
TTAGAGGGATATACAG-1	MOB::Gr
TTAGAGTTTAGAAGGA-1	CPu
TTAGCTAATACGATCT-1	SS::L5
TTAGCTGATTTGCCGT-1	CPu
TTAGTAAACCTGCTCT-1	Pal::MA
TTAGTAGGGCGGCGGG-1	MO::L1
TTAGTTATTCGTGGCA-1	CPu
TTAGTTCAAGTGTTCG-1	SS::L6
TTATAGGTAATTGTCT-1	AcbSh
TTATATACGCTGTCAC-1	CPu
TTATATTTGGCAATCC-1	MO::L5
TTATCCGGGATCTATA-1	CPu
TTATCCTCAAGGAATA-1	MOB::Gr
TTATCTGACATTAGGA-1	MOB::Gr
TTATCTGTATCATAAC-1	MO::L2/3
TTATGAATGAAAGGGA-1	CPu
TTATGACAAACTGGAT-1	MO::L1
TTATGATCTTAACGAA-1	CPu
TTATTAGAGCGTGTTC-1	CPu
TTCAAAGTCTCTAGCC-1	CPu
TTCAATACTCTGAATC-1	CPu
TTCACGAAAGGATCAC-1	MO::L6
TTCACTCGAGCACCTA-1	AcbC
TTCAGCCCTGGTCCAC-1	CPu
TTCAGCTGGCGTGCCC-1	Pal::Sl
TTCAGGCGTCAAAGCC-1	MOB::Opl
TTCATGGCGCAACAGG-1	MO::L2/3
TTCCAATCAGAGCTAG-1	SS::L5
TTCCAATCTGGCTATC-1	ORB::L5
TTCCACACAGATTTGA-1	ORB::L2/3
TTCCAGACGAGATTTA-1	Fim
TTCCATCATGCGGTGA-1	SS::L2/3
TTCCATCGACAGCGTG-1	HY::LPO
TTCCCGGCGCCAATAG-1	MOB::Gr
TTCCGCAGAGAAATAT-1	SS::L5
TTCCGCGTGAGGCGAT-1	CPu
TTCCGGCCTTGAGGCT-1	AOE
TTCCGGCTCGACTTCT-1	SS::L1
TTCCGGTTACCCACTT-1	CPu
TTCCTCGAGGGTGTCT-1	MO::L1
TTCCTCGGACTAACCA-1	CPu
TTCGACAGAGCCCGTG-1	AcbC
TTCGACGGGAAGGGCG-1	MO::L2/3
TTCGCACTCGCGTGCT-1	MO::L2/3
TTCGCACTGTACGACA-1	En
TTCGCCGCTCGCGCTA-1	MOB::Opl
TTCGCGCGCCATACGA-1	AON::L1_1
TTCGCTATCTGACGTG-1	SS::L5
TTCGGCAACCCGCTGA-1	SS::L2/3
TTCGGGACTAATCGCG-1	CPu
TTCGGGCGCTAGTCTT-1	AOE
TTCGGTACTGTAGAGG-1	AON::L1_1
TTCGTACTCCAGAACG-1	MO::L1
TTCGTTCAACGAAGTT-1	SS::L6
TTCTAACCGAAGCTTA-1	CPu
TTCTAGAAAGTCTTAT-1	AON::L1_1
TTCTAGGCCAATTGTG-1	MO::L1
TTCTATTAAACGCAGC-1	Io
TTCTCTTACAGGTGAT-1	MOB::Gl_1
TTCTGACCGGGCTCAA-1	CPu
TTCTGCCGCGCCTAGA-1	CPu
TTCTGCGGGTTAGCGG-1	CPu
TTCTGCTAGACTCCAA-1	CC
TTCTTATCCGCTGGGT-1	Pal::GPi
TTCTTGAGCCGCGCTA-1	ORB::L5
TTCTTGCTAGCATCTC-1	Fim
TTCTTGGACGATCTGC-1	Ft
TTCTTGGAGTAATGAG-1	MO::L5
TTCTTTGGTCGCGACG-1	SS::L6
TTGAAAGGTGTAAAGG-1	SS::L2/3
TTGAACGACGTGCTGA-1	Pal::Sl
TTGAAGAATTCCCAGG-1	MO::L5
TTGAAGGATGGGCGCC-1	MOB::Gl_1
TTGAATATGGACTTTC-1	CPu
TTGAATCGTTGTATAA-1	MOB::Gr
TTGAATTCACGTGAGG-1	CPu
TTGACAGGAGCTCCCG-1	Pal::GPi
TTGACATGAACGTGGA-1	ORB::L2/3
TTGACCAGGAACAACT-1	AcbSh
TTGACCATGTTCTCCG-1	MO::L5
TTGACCGTGTTAATGA-1	ORB::L1
TTGACGCTCCATGAGC-1	St
TTGACTACCATATGGT-1	ORB::L5
TTGACTATTGTCCGGC-1	Pal::GPi
TTGAGAAGTTTAGCAT-1	AcbC
TTGAGAGTACTGCTAA-1	ORB::L5
TTGATAGTCAATACAT-1	SLu
TTGATCTAACTTTGTC-1	MO::L2/3
TTGATGTGTAGTCCCG-1	SS::L5
TTGATTAGCTGTTTCT-1	ORB::L2/3
TTGATTATGCAGATGA-1	MO::L1
TTGCACAATTCAGAAA-1	CC
TTGCACGGAGCAGCAC-1	MO::L2/3
TTGCATGCTGATCACG-1	ORB::L5
TTGCCAAGCAGAACCC-1	TH::RT
TTGCCATAGCCCGCTC-1	MOB::Gr
TTGCCCTGATCACGGG-1	MO::L2/3
TTGCCGCAGACCTACA-1	MOB::Gl_1
TTGCCGCTTTCTAGTA-1	AcbSh
TTGCCGGTGATCCCTC-1	SS::L1
TTGCCTTCTCGCCGGG-1	Pal::NDB
TTGCGCTTGATCAATA-1	Pal::NDB
TTGCGGCATCAGAAAG-1	AOE
TTGCGTCGGCCAACCG-1	ORB::L1
TTGCGTGAACGCTTAG-1	SS::L2/3
TTGCGTGTGTAGGCAT-1	OT::Pl
TTGCTCATAGTACGTG-1	Pal::NDB
TTGCTCCCATACCGGA-1	MO::L5
TTGCTGAAGGAACCAC-1	MO::L1
TTGCTGATCATGTTCG-1	MO::L5
TTGGAAGAATACAGTC-1	AOB::Gr
TTGGACATGTGGCTTA-1	FRP::L2/3
TTGGACCATCTGGCAA-1	TH::RT
TTGGACCTATAACAGT-1	AcbC
TTGGATATCGTCTACG-1	PIR
TTGGCCTAGAATTTCG-1	SS::L2/3
TTGGCTCAATATGTGT-1	Pal::NDB
TTGGGACACTGCCCGC-1	MO::L5
TTGGGACGTAAGAGTT-1	TH::RT
TTGGGCGGCGGTTGCC-1	MO::L6
TTGGTCACACTCGTAA-1	ORB::L5
TTGGTTGCGGTGCGCG-1	MOB::Gr
TTGTAAGGACCTAAGT-1	ORB::L2/3
TTGTAAGGCCAGTTGG-1	MO::L5
TTGTAATCCGTACTCG-1	MO::L5
TTGTACACCTCGAACA-1	MOB::Gr
TTGTCACCGCGGTATC-1	MOB::lpl
TTGTCGTTCAGTTACC-1	MO::L2/3
TTGTGAACCTAATCCG-1	Pal::Sl
TTGTGAGGCATGACGC-1	MOB::Gr
TTGTGATCTGTTCAGT-1	Pal::NDB
TTGTGCAGCCACGTCA-1	AcbC
TTGTGCGGAAGCGGAT-1	MOB::Gl_1
TTGTGGCCCTGACAGT-1	MO::L1
TTGTGGTAGGAGGGAT-1	Ft
TTGTGGTGGTACTAAG-1	Pal::MA
TTGTGTATGCCACCAA-1	AcbC
TTGTGTTTCCCGAAAG-1	PIR
TTGTTCAGTGTGCTAC-1	MO::L5
TTGTTGTGTGTCAAGA-1	MO::L6
TTGTTTCACATCCAGG-1	AON::L1_1
TTGTTTCCATACAACT-1	ORB::L1
